image_name,c1,c2,c3,c4,c5,c_total
10004473376.jpg,0,0,25,73,7,105
10007357496.jpg,0,3,45,47,1,96
10007903636.jpg,1,0,20,73,2,96
10009096245.jpg,0,0,21,75,13,109
100117038.jpg,0,1,21,72,6,100
10012398043.jpg,0,7,55,40,1,103
10013822223.jpg,0,0,48,60,2,110
10014002683.jpg,0,6,46,51,3,106
10017119924.jpg,0,3,58,50,0,111
10020766793.jpg,0,0,11,78,20,109
10020891105.jpg,0,4,80,18,0,102
10022757465.jpg,0,3,32,66,4,105
10022844623.jpg,1,5,60,36,0,102
10027545463.jpg,0,0,31,66,5,102
10027582235.jpg,0,0,24,78,5,107
10029841663.jpg,0,4,65,64,1,134
10031298826.jpg,1,22,90,9,0,122
10031913154.jpg,0,4,63,65,2,134
10039534103.jpg,0,0,34,72,1,107
10041870415.jpg,0,2,53,49,0,104
10043785683.jpg,0,0,46,60,0,106
10047832035.jpg,0,0,38,60,3,101
10048365153.jpg,1,12,66,22,0,101
10050349236.jpg,6,69,27,0,0,102
10058760545.jpg,45,48,7,0,0,100
10059344614.jpg,0,3,46,49,2,100
10061596254.jpg,0,8,74,25,0,107
10067457634.jpg,0,0,15,87,7,109
10068507976.jpg,0,11,77,22,0,110
10068778516.jpg,0,1,38,71,4,114
10069534975.jpg,0,1,34,72,1,108
10071864114.jpg,0,1,31,76,4,112
10075168775.jpg,0,1,30,66,4,101
10077468576.jpg,0,0,38,66,2,106
10077880165.jpg,9,70,28,1,0,108
10079711433.jpg,0,11,93,28,0,132
10082923485.jpg,0,16,77,11,0,104
10086300493.jpg,0,2,49,49,3,103
100882570.jpg,0,6,49,41,3,99
10089027076.jpg,29,66,11,2,0,108
10089177336.jpg,0,1,31,63,6,101
10091520555.jpg,4,66,36,0,0,106
10093057603.jpg,0,4,55,43,0,102
10094235786.jpg,0,2,69,29,0,100
10110458216.jpg,0,4,56,39,1,100
10111411235.jpg,41,65,7,0,0,113
10113730664.jpg,0,1,66,62,0,129
10115071674.jpg,0,2,34,64,9,109
10118773964.jpg,0,12,74,14,1,101
10121813934.jpg,0,11,48,44,2,105
10125013364.jpg,13,80,38,0,0,131
10126177964.jpg,0,1,48,54,6,109
10126857344.jpg,0,6,44,63,1,114
10130566006.jpg,0,1,38,60,7,106
10131980434.jpg,1,8,90,36,0,135
10133867305.jpg,0,6,73,26,0,105
10134737015.jpg,1,19,65,22,0,107
10140071304.jpg,0,7,63,31,2,103
10147970884.jpg,0,0,25,82,4,111
10153847086.jpg,0,9,74,25,1,109
10154367094.jpg,0,2,46,68,1,117
10154991453.jpg,0,4,48,72,2,126
10155925686.jpg,0,21,65,16,1,103
101601008.jpg,0,10,50,38,2,100
10164654253.jpg,0,16,71,13,0,100
10164842933.jpg,0,1,24,81,7,113
10169304416.jpg,0,1,13,79,12,105
10173544123.jpg,0,5,77,48,1,131
10177270623.jpg,2,11,44,44,1,102
10177793964.jpg,0,2,54,41,0,97
10178112894.jpg,2,49,51,4,0,106
10178183416.jpg,0,0,33,68,6,107
10178914656.jpg,0,0,53,52,1,106
10183769356.jpg,0,2,43,55,5,105
10186643874.jpg,1,24,90,11,0,126
10186680555.jpg,0,14,70,19,1,104
10186832194.jpg,1,14,54,28,4,101
10187102065.jpg,2,63,35,7,0,107
10187522803.jpg,0,0,55,52,1,108
10191607755.jpg,0,2,16,64,20,102
10196228605.jpg,0,5,62,41,0,108
10203647273.jpg,0,2,31,69,5,107
10205220286.jpg,9,77,20,0,0,106
10206674394.jpg,0,0,18,76,6,100
10207172624.jpg,0,6,49,45,1,101
10209014225.jpg,0,4,58,42,0,104
10209917915.jpg,1,35,55,10,1,102
10211880874.jpg,12,51,43,1,0,107
10213881683.jpg,5,77,52,2,0,136
10218118033.jpg,0,1,25,76,5,107
10221144393.jpg,37,71,2,0,0,110
10224586444.jpg,2,52,47,1,0,102
10226277514.jpg,2,44,55,5,0,106
10226524916.jpg,38,52,15,2,0,107
10227210045.jpg,0,5,48,48,2,103
10241630856.jpg,0,5,61,39,1,106
10241895785.jpg,0,4,39,57,3,103
10244314384.jpg,2,34,52,15,0,103
10244715656.jpg,1,25,61,22,0,109
10246311914.jpg,0,0,25,73,9,107
10246318724.jpg,0,0,24,77,5,106
10258169584.jpg,0,10,70,25,0,105
10260190424.jpg,0,0,56,49,3,108
1026198859.jpg,0,2,40,61,1,104
10262588616.jpg,1,2,68,29,0,100
10264804094.jpg,0,1,28,76,1,106
10264984793.jpg,0,4,45,50,2,101
10265315316.jpg,0,2,67,32,1,102
10265809113.jpg,0,0,36,65,2,103
10273804555.jpg,0,4,47,49,4,104
10278246465.jpg,0,2,56,71,0,129
10279904885.jpg,3,43,46,10,1,103
10280683815.jpg,0,1,30,67,5,103
10280835505.jpg,6,66,27,1,0,100
10283619534.jpg,0,2,30,65,3,100
10287677265.jpg,1,5,42,53,1,102
10289468185.jpg,0,0,35,62,4,101
10290759976.jpg,0,0,23,77,3,103
1029470257.jpg,0,45,62,4,0,111
10295875445.jpg,0,6,54,48,1,109
10296038236.jpg,1,52,52,3,1,109
10299438733.jpg,0,13,66,23,0,102
102995966.jpg,46,51,7,0,0,104
10316734944.jpg,0,2,50,49,0,101
10319186405.jpg,0,18,57,26,1,102
10319713194.jpg,82,30,0,0,0,112
10325321.jpg,0,0,22,73,9,104
10327985614.jpg,0,1,34,66,8,109
10329149264.jpg,0,0,31,70,3,104
10329235193.jpg,0,2,17,66,27,112
10330831494.jpg,1,29,67,7,0,104
10335072144.jpg,0,16,49,42,0,107
10336689775.jpg,0,4,77,48,0,129
103400056.jpg,0,3,18,63,20,104
10342569703.jpg,1,57,44,1,0,103
10344523015.jpg,1,21,71,15,0,108
10344921126.jpg,93,16,0,0,0,109
10346758803.jpg,0,11,45,40,5,101
10346796664.jpg,0,1,41,60,2,104
10349956885.jpg,0,3,32,65,5,105
10350497833.jpg,2,9,66,27,1,105
10351189716.jpg,0,2,74,30,0,106
10353620913.jpg,1,17,59,25,0,102
10358252894.jpg,0,3,88,46,0,137
10362672006.jpg,0,1,19,81,3,104
10366373284.jpg,1,0,14,94,3,112
1036840624.jpg,8,68,20,0,0,96
10371125786.jpg,2,61,38,4,0,105
10371211803.jpg,0,0,63,49,1,113
10372323314.jpg,0,0,64,44,1,109
10373546175.jpg,0,7,67,25,0,99
10375167904.jpg,0,7,70,25,0,102
10382843045.jpg,1,29,64,10,0,104
10387390396.jpg,0,0,39,63,2,104
10387844376.jpg,0,10,43,53,3,109
10388184626.jpg,0,1,23,70,6,100
10395523125.jpg,0,10,58,32,1,101
10397166423.jpg,0,0,42,64,3,109
10397631976.jpg,0,0,35,69,3,107
10399580503.jpg,0,0,27,73,4,104
10403509543.jpg,0,2,50,52,0,104
10407720764.jpg,1,59,40,3,0,103
10408374535.jpg,0,31,67,9,0,107
10408474376.jpg,0,0,15,83,11,109
10409059825.jpg,0,0,38,66,2,106
10410038143.jpg,0,1,20,70,12,103
10412894895.jpg,0,6,77,17,0,100
10414716033.jpg,0,0,40,60,3,103
10415628976.jpg,45,59,17,0,0,121
10415631353.jpg,1,49,52,7,0,109
104219737.jpg,1,29,50,22,0,102
10422425365.jpg,0,2,21,76,2,101
10422776735.jpg,0,2,58,66,0,126
10423472445.jpg,0,1,41,68,0,110
10429780626.jpg,0,0,42,54,0,96
10430002553.jpg,0,1,21,71,7,100
10430335945.jpg,3,47,54,2,0,106
10440370734.jpg,4,60,39,6,0,109
10442628686.jpg,6,48,83,3,0,140
10446770756.jpg,0,0,43,54,5,102
10446810546.jpg,0,0,36,69,4,109
10451177016.jpg,0,2,41,54,4,101
10453950204.jpg,0,6,79,22,0,107
10458591.jpg,0,28,57,14,2,101
10458703674.jpg,5,59,35,3,0,102
10459022813.jpg,0,0,15,81,11,107
10463545414.jpg,0,13,82,14,0,109
10463583515.jpg,0,0,21,76,3,100
10464940425.jpg,0,0,48,61,2,111
10465121613.jpg,0,5,67,34,1,107
10465293055.jpg,0,1,25,69,5,100
10466350116.jpg,0,0,28,76,8,112
10466453556.jpg,11,78,17,0,0,106
10468110795.jpg,0,7,60,38,1,106
10468540574.jpg,0,4,47,47,3,101
10469774844.jpg,1,7,76,26,0,110
10471406506.jpg,13,79,21,0,0,113
10474002734.jpg,0,0,20,84,2,106
10475435053.jpg,0,15,64,25,3,107
10475658035.jpg,0,0,12,70,27,109
10481974434.jpg,2,51,51,7,0,111
10486107003.jpg,0,4,55,44,0,103
10490369963.jpg,3,53,43,5,0,104
10491358066.jpg,0,5,50,44,2,101
10491423125.jpg,0,3,39,61,3,106
10492897986.jpg,2,30,69,5,0,106
10505275743.jpg,0,0,23,70,8,101
10506082433.jpg,1,49,55,3,0,108
10512432565.jpg,0,4,46,58,1,109
10513907744.jpg,0,12,59,26,1,98
10516786036.jpg,0,1,28,69,11,109
10517436165.jpg,4,35,66,0,0,105
10520192995.jpg,0,16,69,21,0,106
10525460645.jpg,0,3,35,60,6,104
10526881085.jpg,0,42,63,3,1,109
10530470795.jpg,1,58,42,5,0,106
10532663625.jpg,0,1,44,58,1,104
10534454676.jpg,0,0,41,62,2,105
10535849673.jpg,0,25,65,8,0,98
10536668436.jpg,5,72,52,1,0,130
10538085833.jpg,1,36,96,19,0,152
10539008983.jpg,0,5,43,60,1,109
10539142034.jpg,0,1,40,107,3,151
10539341593.jpg,0,1,34,65,1,101
10544775715.jpg,0,34,67,7,0,108
10544833625.jpg,0,17,71,13,0,101
10544945153.jpg,0,27,68,9,0,104
10554234623.jpg,0,19,86,8,0,113
10556629035.jpg,0,2,34,64,2,102
10558118243.jpg,0,0,34,70,8,112
105620456.jpg,1,18,61,27,1,108
10567114974.jpg,0,8,53,47,1,109
10567188645.jpg,0,1,64,40,1,106
10568567754.jpg,0,2,23,79,7,111
10569725133.jpg,0,0,28,75,4,107
1057328504.jpg,11,57,36,1,0,105
10574233584.jpg,2,22,60,17,0,101
10575593285.jpg,0,6,72,25,0,103
10576676414.jpg,0,4,72,51,0,127
10579282866.jpg,0,6,54,52,0,112
1057997640.jpg,1,17,70,17,0,105
10581525775.jpg,0,5,93,42,0,140
10582113466.jpg,0,12,68,24,0,104
10583786994.jpg,0,14,50,34,4,102
10586872235.jpg,2,43,60,1,0,106
10589450596.jpg,1,6,77,41,1,126
10597114264.jpg,0,0,38,65,2,105
10602786066.jpg,19,67,20,2,0,108
10603218265.jpg,0,1,32,71,1,105
10604417276.jpg,0,0,27,67,7,101
10605846204.jpg,0,1,48,60,0,109
10609356094.jpg,0,5,51,43,6,105
10614052044.jpg,0,1,23,81,4,109
10615424764.jpg,0,0,41,57,6,104
10617981003.jpg,3,50,51,1,0,105
10619909515.jpg,0,3,73,31,0,107
10620203775.jpg,37,49,15,1,0,102
10620356404.jpg,0,10,68,28,0,106
1062133952.jpg,0,6,76,27,2,111
10625988224.jpg,0,4,59,38,1,102
10628337356.jpg,0,3,29,71,1,104
10628497685.jpg,0,18,65,26,0,109
10628645805.jpg,0,0,19,71,12,102
10631219374.jpg,0,4,42,61,1,108
10631630073.jpg,20,81,4,0,0,105
1063351510.jpg,0,37,63,9,0,109
10633933603.jpg,0,10,75,27,0,112
10635160054.jpg,0,1,61,62,0,124
1063722220.jpg,0,11,85,15,0,111
10642085843.jpg,0,0,25,75,7,107
10644234544.jpg,0,15,74,19,0,108
106456452.jpg,19,64,16,1,0,100
10660362264.jpg,0,0,32,66,7,105
10660571735.jpg,1,28,72,11,0,112
10660620125.jpg,0,1,37,67,6,111
106652866.jpg,0,29,50,19,0,98
10665464526.jpg,0,0,20,76,9,105
10676427864.jpg,0,0,23,74,2,99
1067765170.jpg,0,23,75,9,0,107
10678199353.jpg,0,1,50,57,0,108
10678350303.jpg,0,4,53,52,5,114
10679134563.jpg,7,64,25,2,0,98
10680153225.jpg,2,39,58,7,0,106
10680502673.jpg,0,1,16,75,15,107
10680715605.jpg,6,56,45,3,0,110
10680932454.jpg,0,27,63,18,0,108
10683218616.jpg,0,2,41,68,1,112
10686332213.jpg,0,12,70,24,0,106
10689376076.jpg,0,6,88,19,1,114
10689538413.jpg,0,2,28,71,7,108
10689722684.jpg,0,0,19,82,7,108
10690294454.jpg,0,2,37,70,0,109
10692654005.jpg,0,3,52,51,1,107
10692667386.jpg,0,0,46,52,5,103
10692857705.jpg,0,3,44,47,8,102
10693826785.jpg,0,19,68,17,0,104
10694350076.jpg,0,3,36,67,1,107
10698962263.jpg,3,41,47,8,0,99
10705911926.jpg,0,2,39,55,4,100
10706770686.jpg,0,0,25,78,3,106
10713772814.jpg,0,7,71,30,0,108
10714662986.jpg,0,0,10,90,13,113
10715577856.jpg,3,40,54,8,0,105
10721124556.jpg,0,17,61,31,1,110
10723077086.jpg,0,7,34,64,1,106
10724461514.jpg,0,2,36,67,3,108
10724889206.jpg,0,3,57,38,0,98
10728525673.jpg,0,1,45,58,0,104
10730634575.jpg,0,16,64,24,0,104
10732971054.jpg,0,19,75,8,0,102
10733259996.jpg,0,4,69,27,0,100
10737029565.jpg,0,6,60,38,1,105
10740242265.jpg,0,3,37,60,0,100
10740725955.jpg,0,1,10,87,4,102
10740727595.jpg,0,1,30,74,4,109
10745415703.jpg,0,3,51,45,4,103
10745932825.jpg,0,4,51,50,1,106
10747724694.jpg,0,10,73,19,0,102
107505789.jpg,0,13,64,23,0,100
10751799554.jpg,0,2,30,66,4,102
1075190309.jpg,5,53,47,4,1,110
10762659033.jpg,1,47,45,7,0,100
10765812585.jpg,2,38,59,7,0,106
10767441335.jpg,0,1,28,68,7,104
10770026303.jpg,0,0,39,66,1,106
10770700455.jpg,0,6,70,33,1,110
10773126784.jpg,0,0,19,77,6,102
10775358296.jpg,10,53,42,7,0,112
10776111906.jpg,0,0,35,61,5,101
107799222.jpg,0,1,28,70,3,102
10783395635.jpg,0,0,45,62,2,109
10784159775.jpg,0,1,20,76,5,102
10786271105.jpg,0,1,54,55,0,110
10787038944.jpg,0,9,60,35,0,104
10787258285.jpg,0,0,42,61,7,110
10790803694.jpg,0,3,46,90,1,140
10791502435.jpg,0,0,35,73,2,110
10792125886.jpg,0,2,60,66,1,129
10798439785.jpg,0,12,64,26,0,102
10799367156.jpg,0,0,31,69,5,105
10799853136.jpg,0,2,51,53,1,107
10805317444.jpg,0,15,73,13,0,101
10806677866.jpg,0,7,63,33,0,103
10813730303.jpg,4,81,69,1,0,155
10814874265.jpg,0,2,25,78,1,106
10819001424.jpg,29,65,10,0,0,104
10819132874.jpg,0,1,34,66,2,103
10819329365.jpg,0,2,81,18,0,101
10827568885.jpg,0,1,25,74,9,109
10828147985.jpg,1,15,76,16,0,108
10828395135.jpg,0,0,38,63,6,107
10829329963.jpg,0,1,27,79,0,107
10836905604.jpg,0,0,31,69,3,103
10843403305.jpg,0,1,51,49,3,104
10847909336.jpg,13,83,8,0,0,104
10849117054.jpg,0,11,76,21,0,108
10849700404.jpg,0,3,38,63,3,107
1084984228.jpg,11,57,35,5,0,108
1085590803.jpg,25,66,13,1,0,105
10856434794.jpg,1,45,63,4,0,113
10856757.jpg,17,59,28,5,0,109
10858952303.jpg,1,43,56,6,0,106
10861031374.jpg,0,2,58,44,0,104
10862487886.jpg,0,5,62,39,1,107
10864812016.jpg,0,12,77,17,0,106
10865798996.jpg,0,0,23,69,8,100
10866463396.jpg,1,2,52,47,2,104
10866561184.jpg,0,0,19,81,5,105
10868390853.jpg,0,2,43,82,3,130
10872249945.jpg,0,1,20,76,8,105
10875461386.jpg,0,16,72,19,0,107
10880314705.jpg,0,1,26,75,9,111
10882856833.jpg,0,5,69,33,1,108
10883456586.jpg,11,74,17,2,0,104
1089100444.jpg,0,4,62,40,0,106
10893404795.jpg,0,58,42,0,0,100
10895044423.jpg,13,56,40,0,0,109
10897840884.jpg,0,3,28,66,9,106
10898287705.jpg,1,42,54,10,0,107
10898689245.jpg,0,5,62,44,1,112
10899733355.jpg,0,1,47,80,1,129
10900020096.jpg,0,3,46,57,0,106
10905088155.jpg,0,7,59,41,1,108
10905114716.jpg,0,23,74,8,0,105
10906887886.jpg,1,45,52,4,0,102
1090979049.jpg,0,5,88,15,0,108
10910262455.jpg,2,43,54,6,0,105
10911046243.jpg,0,0,28,71,4,103
10911095273.jpg,0,1,39,62,5,107
10912602716.jpg,0,1,44,86,2,133
10915557435.jpg,0,53,51,1,0,105
10917741563.jpg,0,1,34,69,2,106
10921653346.jpg,0,1,19,63,26,109
10921880365.jpg,0,2,46,56,1,105
10923819485.jpg,1,53,45,8,0,107
10925112255.jpg,32,45,20,1,0,98
10927420963.jpg,0,2,56,52,1,111
10931213005.jpg,0,39,59,9,0,107
10932590295.jpg,6,53,45,4,0,108
10933722123.jpg,1,15,78,15,0,109
10936496124.jpg,0,7,61,33,1,102
10937404313.jpg,3,12,58,36,1,110
10947519133.jpg,0,1,34,70,0,105
10948257133.jpg,3,43,52,5,0,103
10953973716.jpg,0,0,37,63,3,103
10961758274.jpg,0,1,21,84,1,107
10967023396.jpg,0,14,67,24,0,105
10968711744.jpg,0,0,18,78,8,104
10980930876.jpg,0,1,42,58,6,107
10981006796.jpg,36,56,7,0,0,99
109825878.jpg,5,56,43,2,0,106
10983119996.jpg,0,10,74,17,0,101
10990397626.jpg,9,54,43,2,0,108
10990887046.jpg,1,18,98,28,1,146
11004139923.jpg,0,2,54,45,0,101
11005410885.jpg,0,11,85,17,0,113
11006895124.jpg,0,13,41,45,4,103
1100873520.jpg,1,22,76,8,0,107
11009340314.jpg,0,6,56,39,1,102
11010062705.jpg,0,1,51,48,1,101
11013892854.jpg,6,93,12,0,0,111
11016309165.jpg,0,6,62,37,0,105
11016485883.jpg,0,0,52,54,1,107
11018079835.jpg,0,0,22,86,2,110
1101948952.jpg,0,0,26,73,1,100
11021514993.jpg,0,1,52,45,2,100
11021929275.jpg,0,2,32,66,1,101
11023346856.jpg,0,2,73,28,1,104
11031973684.jpg,1,0,35,72,3,111
11033459414.jpg,0,7,50,43,3,103
110356262.jpg,4,63,36,3,0,106
11035760784.jpg,0,4,55,46,1,106
1103755154.jpg,0,3,31,76,1,111
11051034136.jpg,0,1,60,47,0,108
11051374673.jpg,0,4,65,31,0,100
11051749575.jpg,0,5,64,31,0,100
11054039594.jpg,3,43,55,6,0,107
11054638863.jpg,0,10,59,33,0,102
11054899145.jpg,0,2,31,76,1,110
11054955216.jpg,5,53,48,0,0,106
11058112996.jpg,16,52,30,6,1,105
11060185873.jpg,1,2,60,48,0,111
11061633946.jpg,7,51,43,3,0,104
11062902804.jpg,0,3,39,61,4,107
11063650646.jpg,1,7,67,32,0,107
11068654734.jpg,0,6,50,46,1,103
11071132393.jpg,1,3,35,62,3,104
11078122366.jpg,0,2,38,64,1,105
11079282234.jpg,0,0,40,95,1,136
11081975613.jpg,0,3,44,52,3,102
11087687983.jpg,0,0,17,91,3,111
11089447095.jpg,0,3,56,48,0,107
11095381506.jpg,0,2,19,69,10,100
11097661494.jpg,0,3,29,70,2,104
11098121724.jpg,0,0,41,65,4,110
11109548195.jpg,0,8,62,37,0,107
11111585533.jpg,0,0,5,92,12,109
11118140253.jpg,0,0,45,55,4,104
11124139926.jpg,1,29,66,9,0,105
11126091314.jpg,0,40,60,3,0,103
11126232436.jpg,0,19,72,12,0,103
11126652126.jpg,1,25,52,20,5,103
11139368236.jpg,0,2,42,66,0,110
11139580153.jpg,0,38,58,5,0,101
11141708043.jpg,0,6,43,50,1,100
11143825565.jpg,1,7,60,38,3,109
11148529964.jpg,1,7,92,21,0,121
11149566996.jpg,0,28,65,9,0,102
11150131936.jpg,0,5,69,31,2,107
11153943035.jpg,0,12,59,25,2,98
11155257336.jpg,0,8,84,16,0,108
11156365526.jpg,0,32,64,12,0,108
11158314215.jpg,1,39,60,7,0,107
11159983896.jpg,0,1,45,55,5,106
11163249414.jpg,0,1,55,41,0,97
11165746213.jpg,1,2,54,41,5,103
11169904264.jpg,0,1,55,48,2,106
11170758174.jpg,0,5,68,31,0,104
11170786154.jpg,0,3,48,55,2,108
11172371243.jpg,0,1,28,65,7,101
11175382195.jpg,2,34,60,14,2,112
11175538013.jpg,2,0,36,64,6,108
11183022383.jpg,2,40,58,5,0,105
11201160185.jpg,0,8,65,34,0,107
11208321473.jpg,0,1,46,54,3,104
11209059333.jpg,0,9,70,28,1,108
11209188974.jpg,0,1,58,44,2,105
11209221046.jpg,1,12,57,26,1,97
11209649786.jpg,0,0,58,46,0,104
11215941184.jpg,0,3,38,59,5,105
11216436636.jpg,0,2,33,72,1,108
11218793016.jpg,0,5,73,30,0,108
11219420725.jpg,0,0,38,60,3,101
11221904805.jpg,0,2,25,78,1,106
11226958966.jpg,0,1,29,81,3,114
11229777185.jpg,0,6,56,45,1,108
11232665444.jpg,15,61,30,3,0,109
11239106136.jpg,0,22,95,21,0,138
11241096796.jpg,0,2,43,61,1,107
11242015725.jpg,0,4,56,41,0,101
11245083256.jpg,1,9,52,42,5,109
11245781693.jpg,0,2,46,52,1,101
11250215644.jpg,0,0,44,64,0,108
11251138933.jpg,0,0,52,55,0,107
11252383376.jpg,0,4,37,57,2,100
11252644224.jpg,0,4,60,39,0,103
11253432804.jpg,0,6,64,29,1,100
11256485296.jpg,0,9,64,31,0,104
11256776836.jpg,0,2,47,58,3,110
11260247205.jpg,0,3,23,63,11,100
11260270773.jpg,0,0,37,61,4,102
11260385706.jpg,0,1,39,61,2,103
11262156493.jpg,0,2,27,95,5,129
11264048414.jpg,28,74,6,0,0,108
11268202995.jpg,2,49,50,7,1,109
11269474243.jpg,0,0,32,60,7,99
11269626135.jpg,0,1,16,80,6,103
11270256213.jpg,0,1,59,42,3,105
11270280904.jpg,13,57,30,5,0,105
11273127766.jpg,0,1,25,65,13,104
11273190884.jpg,0,0,30,78,2,110
11275584366.jpg,1,26,70,8,0,105
11287273183.jpg,0,1,28,75,2,106
11288559554.jpg,0,4,76,27,0,107
11291450085.jpg,0,15,67,24,0,106
11292980633.jpg,0,1,68,72,0,141
11293176185.jpg,0,8,59,36,0,103
11293946974.jpg,0,1,29,70,1,101
11294894953.jpg,0,11,71,28,1,111
11295475784.jpg,1,23,71,8,0,103
11297504114.jpg,1,14,64,20,2,101
11297570034.jpg,0,17,64,23,0,104
11301386435.jpg,0,2,28,69,11,110
11302087114.jpg,0,4,45,55,6,110
1130601148.jpg,0,0,43,59,5,107
11307198154.jpg,0,0,21,72,7,100
11310848503.jpg,0,3,40,60,4,107
11316105544.jpg,0,0,20,85,4,109
11320098306.jpg,0,22,71,15,0,108
11321228905.jpg,0,1,25,71,10,107
11324704676.jpg,1,27,69,14,0,111
11325081573.jpg,2,28,62,12,0,104
11327123904.jpg,0,0,38,63,0,101
11333447674.jpg,0,0,21,82,6,109
11333611705.jpg,0,6,69,31,1,107
11333782783.jpg,0,1,44,63,0,108
11335231214.jpg,0,4,51,49,1,105
11338371864.jpg,0,1,55,46,0,102
11339056674.jpg,0,3,57,44,1,105
11341117543.jpg,0,6,68,25,0,99
11346267905.jpg,0,2,41,55,1,99
11347140483.jpg,1,15,72,23,0,111
11353895754.jpg,0,2,35,64,5,106
11356760053.jpg,0,1,34,61,4,100
113663782.jpg,0,2,43,52,2,99
11369797883.jpg,0,0,32,62,6,100
113701797.jpg,1,28,66,10,0,105
11370407443.jpg,0,38,61,7,0,106
11372421485.jpg,0,4,60,37,1,102
11378848184.jpg,1,4,62,40,2,109
11381486584.jpg,0,21,72,16,1,110
11382799454.jpg,0,3,29,63,6,101
11389102005.jpg,0,5,69,29,0,103
11389330254.jpg,1,8,48,46,1,104
11393787465.jpg,32,64,8,1,0,105
11396447303.jpg,0,28,65,11,0,104
11399456186.jpg,0,8,57,38,1,104
11404463006.jpg,0,13,79,12,0,104
11406584295.jpg,0,10,72,23,0,105
11407368256.jpg,0,1,38,70,3,112
11407704456.jpg,0,3,36,62,2,103
11407835876.jpg,1,10,87,38,0,136
11407862453.jpg,0,0,44,63,3,110
11408091114.jpg,0,1,51,52,4,108
11408307524.jpg,0,6,55,45,1,107
11408357925.jpg,0,12,68,28,0,108
11408443745.jpg,0,5,59,36,0,100
11410644126.jpg,0,7,59,41,0,107
11410690075.jpg,0,2,47,53,2,104
11414474354.jpg,37,60,7,0,0,104
11414784395.jpg,0,2,72,79,1,154
11416241303.jpg,0,4,54,52,1,111
11419816946.jpg,0,0,34,84,3,121
11424871693.jpg,2,62,41,3,0,108
11426976205.jpg,6,63,40,2,0,111
11432746805.jpg,0,3,63,45,2,113
11433127464.jpg,0,15,80,15,0,110
11433593823.jpg,0,4,68,32,2,106
11436378704.jpg,0,0,15,80,8,103
11436390143.jpg,0,1,45,54,3,103
11436508006.jpg,0,5,72,44,0,121
11437542656.jpg,1,10,73,24,0,108
11438612393.jpg,10,58,29,1,0,98
11439591215.jpg,6,70,25,0,0,101
11446005074.jpg,0,2,26,61,19,108
11452299875.jpg,0,1,24,77,3,105
11453100924.jpg,0,0,19,81,7,107
11456199025.jpg,7,61,32,2,0,102
11459826225.jpg,0,5,66,38,0,109
11460414725.jpg,0,2,44,56,0,102
11461273913.jpg,0,2,38,62,2,104
11474376103.jpg,3,26,58,24,1,112
11476172786.jpg,0,1,36,57,7,101
11477250346.jpg,0,0,22,78,3,103
11484412296.jpg,0,4,74,30,0,108
11490304024.jpg,0,28,56,22,1,107
11495616074.jpg,1,66,38,1,0,106
11498400544.jpg,1,25,101,13,0,140
11499073263.jpg,9,78,21,1,0,109
11501016504.jpg,0,15,63,27,0,105
11501322724.jpg,0,0,28,77,5,110
11503076944.jpg,0,0,23,73,5,101
11504259765.jpg,2,40,55,6,0,103
11504601393.jpg,1,25,59,21,0,106
11506037556.jpg,0,27,91,18,0,136
11509515706.jpg,4,66,42,1,0,113
11511265293.jpg,26,65,13,0,0,104
11514342335.jpg,0,1,36,63,3,103
11515148456.jpg,0,5,63,35,3,106
11518631385.jpg,17,51,35,4,0,107
11519797605.jpg,0,1,29,71,6,107
11520125355.jpg,0,5,44,54,0,103
11521791886.jpg,0,23,64,17,0,104
11522920033.jpg,0,12,66,25,1,104
11522984926.jpg,1,58,77,3,0,139
11523093675.jpg,0,2,35,63,6,106
1152554814.jpg,4,61,35,7,0,107
11527524903.jpg,1,69,30,0,0,100
115290990.jpg,9,34,52,9,0,104
11529156723.jpg,0,0,42,63,0,105
11533404563.jpg,0,3,53,48,1,105
11535275706.jpg,0,1,28,66,6,101
11541375264.jpg,0,19,82,7,0,108
11546100824.jpg,0,2,42,51,3,98
11548683805.jpg,1,52,56,5,0,114
1154962046.jpg,45,58,2,0,0,105
11551017545.jpg,0,3,51,46,1,101
11554709013.jpg,0,0,43,55,1,99
11555549865.jpg,0,5,67,32,0,104
11559530473.jpg,0,10,64,36,0,110
1159028861.jpg,0,0,36,71,2,109
11706252.jpg,8,72,23,4,0,107
117172917.jpg,0,5,57,41,0,103
1172858625.jpg,0,2,50,55,2,109
1194894463.jpg,0,3,56,46,0,105
1195689121.jpg,7,68,30,0,0,105
1202598832.jpg,0,7,65,35,0,107
120328351.jpg,3,51,50,2,0,106
120459577.jpg,0,29,50,19,1,99
120983206.jpg,0,8,53,43,2,106
121123359.jpg,0,0,5,59,36,100
122346209.jpg,16,53,29,7,0,105
122553631.jpg,3,60,43,1,0,107
122760647.jpg,1,23,58,17,0,99
123242995.jpg,0,9,51,38,1,99
1240561841.jpg,0,0,24,78,6,108
1241002913.jpg,1,19,72,11,0,103
1249337589.jpg,0,1,39,56,5,101
1252945239.jpg,45,55,6,0,0,106
125829275.jpg,10,60,28,5,0,103
1266777709.jpg,1,5,58,42,0,106
127977276.jpg,0,0,19,62,18,99
128079586.jpg,1,15,47,39,0,102
128293583.jpg,0,4,26,63,9,102
1286765019.jpg,0,0,40,61,4,105
128715765.jpg,0,18,54,29,0,101
128781220.jpg,3,15,36,42,3,99
1288155068.jpg,0,10,90,30,0,130
1289162225.jpg,0,4,73,36,0,113
129023751.jpg,0,0,13,80,6,99
1292518332.jpg,0,0,53,50,0,103
12949713.jpg,0,1,12,61,30,104
1295925783.jpg,4,71,26,0,0,101
1296759644.jpg,4,69,26,1,0,100
1296775174.jpg,4,59,37,4,0,104
1297819816.jpg,0,0,36,70,3,109
1302738127.jpg,0,0,27,80,4,111
1306121832.jpg,18,57,29,1,0,105
1306193020.jpg,7,69,30,2,0,108
1312413141.jpg,37,57,9,1,0,104
1313706108.jpg,3,71,33,0,0,107
1314838096.jpg,0,4,56,39,0,99
1315889745.jpg,12,72,20,3,0,107
1316239068.jpg,0,5,62,37,0,104
1317678723.jpg,2,57,39,3,0,101
132921013.jpg,0,3,26,67,6,102
1329449674.jpg,0,34,55,10,0,99
1329713028.jpg,0,15,65,19,1,100
1331642031.jpg,0,19,107,14,0,140
1332211559.jpg,23,72,7,1,0,103
13325497.jpg,0,11,54,33,4,102
133829142.jpg,18,67,14,0,0,99
134343714.jpg,12,40,35,14,1,102
1348094685.jpg,0,1,31,71,5,108
1348788122.jpg,1,19,67,9,0,96
1351464251.jpg,0,0,46,53,2,101
1351917139.jpg,0,5,75,33,0,113
1352428885.jpg,0,25,72,10,0,107
135352055.jpg,44,50,5,0,0,99
135403304.jpg,27,54,18,3,0,102
1357295757.jpg,1,5,49,63,5,123
1360063696.jpg,0,1,46,57,1,105
1360663704.jpg,0,0,24,81,5,110
1362231035.jpg,0,1,36,58,5,100
136287514.jpg,27,64,13,0,0,104
1367218588.jpg,8,78,20,0,0,106
1368120580.jpg,0,0,13,91,6,110
136948336.jpg,0,0,16,76,14,106
1375320148.jpg,2,14,63,21,3,103
137731604.jpg,33,55,16,0,0,104
137841242.jpg,0,4,38,50,8,100
138750201.jpg,0,20,54,27,3,104
1387568510.jpg,16,68,20,0,0,104
1392405539.jpg,0,5,64,28,0,97
139253033.jpg,9,71,25,1,0,106
1396109073.jpg,0,10,60,40,1,111
139611767.jpg,42,46,9,1,1,99
1396758393.jpg,0,15,68,17,0,100
139999071.jpg,21,68,14,2,0,105
1402675396.jpg,11,81,19,1,0,112
1404458044.jpg,1,48,49,3,0,101
1408118135.jpg,1,39,65,5,0,110
1408827056.jpg,4,72,25,1,0,102
14092652.jpg,0,5,41,50,11,107
1410303503.jpg,0,4,45,53,2,104
141087919.jpg,0,1,11,76,11,99
1413089132.jpg,2,50,44,8,0,104
141683460.jpg,0,4,37,56,5,102
1418012844.jpg,30,59,13,1,0,103
142117255.jpg,0,6,44,48,7,105
142607218.jpg,1,18,58,26,2,105
1427484100.jpg,0,1,45,55,2,103
1428835063.jpg,0,15,76,12,0,103
1429120335.jpg,0,11,71,25,0,107
1429419760.jpg,1,1,43,66,0,111
1429848565.jpg,0,4,45,49,2,100
1430765461.jpg,0,22,69,15,0,106
1431934782.jpg,1,7,66,37,1,112
143394138.jpg,13,66,26,1,0,106
1434258458.jpg,0,4,50,47,6,107
143622689.jpg,0,8,51,44,2,105
143643298.jpg,29,63,12,0,0,104
143899204.jpg,4,36,56,10,0,106
144272742.jpg,38,45,17,5,0,105
1446670895.jpg,0,6,65,35,0,106
145089144.jpg,35,69,2,0,0,106
145215893.jpg,68,35,1,0,0,104
145517507.jpg,2,52,49,5,0,108
1459611891.jpg,5,64,34,1,0,104
1461013559.jpg,1,4,62,43,0,110
1465282532.jpg,6,62,33,3,0,104
1465706268.jpg,0,4,78,21,1,104
1466864952.jpg,1,32,94,2,0,129
146926363.jpg,73,31,1,0,0,105
1473138944.jpg,7,67,28,0,0,102
147639760.jpg,2,36,42,19,1,100
147783170.jpg,9,55,38,2,0,104
1487386722.jpg,8,81,17,0,0,106
14898266.jpg,9,51,39,10,0,109
1490095554.jpg,3,14,58,27,1,103
1492755190.jpg,0,12,64,33,1,110
1494601659.jpg,10,63,27,2,0,102
149795981.jpg,0,6,51,45,1,103
149836125.jpg,5,28,47,22,0,102
149867784.jpg,0,3,29,59,7,98
1500316824.jpg,0,3,42,57,2,104
15012954.jpg,15,72,17,0,0,104
1511406857.jpg,0,1,26,68,9,104
1513796016.jpg,1,3,33,63,5,105
1516506386.jpg,0,3,55,45,2,105
1519242706.jpg,0,0,39,66,1,106
1519650440.jpg,1,19,69,18,1,108
1527228794.jpg,19,95,18,0,0,132
152780037.jpg,5,43,42,9,0,99
1529757375.jpg,0,2,51,47,1,101
153557108.jpg,0,7,41,51,5,104
153876946.jpg,0,15,70,19,0,104
1539716347.jpg,1,57,44,3,0,105
1540229828.jpg,0,2,29,71,7,109
154270569.jpg,0,2,33,66,0,101
1543375325.jpg,19,79,9,0,0,107
1543929747.jpg,11,53,35,5,0,104
154603426.jpg,1,8,43,45,4,101
154740129.jpg,81,23,2,0,0,106
155289213.jpg,3,31,54,16,0,104
155365010.jpg,31,57,12,0,0,100
155711788.jpg,59,42,4,0,0,105
155797839.jpg,0,0,19,71,14,104
1558503807.jpg,1,7,61,31,0,100
156015117.jpg,1,10,55,33,4,103
156117321.jpg,10,59,28,1,0,98
1561250178.jpg,0,8,68,31,0,107
1562015932.jpg,0,12,78,17,0,107
156266461.jpg,2,52,48,4,0,106
156451756.jpg,1,29,52,17,0,99
1565882132.jpg,1,40,59,3,0,103
1571972975.jpg,2,34,49,19,1,105
1572596360.jpg,1,15,74,14,0,104
1572804254.jpg,2,17,71,12,0,102
1573719804.jpg,0,2,38,69,2,111
1576235224.jpg,10,77,17,2,0,106
1580074951.jpg,0,6,54,43,3,106
158100229.jpg,0,19,63,19,1,102
159144665.jpg,0,1,27,68,10,106
159838722.jpg,0,4,20,68,7,99
160123908.jpg,1,7,54,40,2,104
16057476.jpg,9,47,43,10,0,109
16079437.jpg,2,23,59,23,0,107
160981911.jpg,0,6,50,48,1,105
160999577.jpg,12,65,22,3,0,102
161483962.jpg,0,20,59,26,0,105
161551525.jpg,1,39,60,5,0,105
1626230781.jpg,42,57,4,0,0,103
163208499.jpg,15,68,18,0,0,101
1634910276.jpg,0,0,33,72,3,108
163666873.jpg,1,36,49,12,0,98
163977327.jpg,25,73,8,0,0,106
1646704912.jpg,0,5,76,20,0,101
165074300.jpg,0,1,34,60,7,102
16523804.jpg,5,48,45,9,0,107
1654836945.jpg,1,25,67,12,0,105
1663721615.jpg,50,55,3,0,0,108
166528976.jpg,0,6,56,43,1,106
1669800671.jpg,1,11,53,38,2,105
1674951001.jpg,2,39,54,14,0,109
1679551869.jpg,0,1,50,53,0,104
16799807.jpg,0,50,51,2,0,103
1682888994.jpg,0,2,50,55,1,108
1693839090.jpg,25,73,9,0,0,107
169625095.jpg,0,40,58,5,0,103
169779095.jpg,0,5,43,56,0,104
1708787959.jpg,0,14,65,29,1,109
171857013.jpg,0,35,54,17,0,106
174715115.jpg,12,73,18,0,0,103
1748861184.jpg,0,6,74,30,1,111
175326787.jpg,5,58,36,2,0,101
1755366250.jpg,46,59,0,0,0,105
17606027.jpg,0,4,41,60,4,109
176663631.jpg,2,9,33,52,5,101
1777841357.jpg,1,13,71,17,1,103
178403727.jpg,5,74,27,0,0,106
1792473649.jpg,0,0,33,75,3,111
1794888173.jpg,4,24,68,12,0,108
1795186582.jpg,7,59,41,2,0,109
1796317547.jpg,0,2,18,77,7,104
1797683075.jpg,8,63,32,4,0,107
1798554647.jpg,0,27,71,10,0,108
1799451312.jpg,0,7,68,34,1,110
1802306299.jpg,2,46,55,3,0,106
1805206682.jpg,9,76,20,2,0,107
1807195948.jpg,4,71,23,2,0,100
1809848435.jpg,17,74,12,0,0,103
1812202754.jpg,0,0,18,83,5,106
181220864.jpg,10,73,20,1,0,104
1814122396.jpg,0,7,67,37,0,111
1820291567.jpg,14,84,9,1,0,108
18238731.jpg,24,75,5,0,0,104
183156510.jpg,1,25,61,15,0,102
18438855.jpg,0,1,33,62,11,107
185458280.jpg,57,37,4,0,0,98
186520031.jpg,1,11,44,40,2,98
187485230.jpg,1,38,47,13,0,99
187499391.jpg,1,32,62,8,0,103
187640892.jpg,8,48,39,5,0,100
1896792999.jpg,0,4,52,50,0,106
189899579.jpg,0,35,56,9,0,100
1929087646.jpg,0,34,70,2,0,106
19300996.jpg,20,73,11,0,0,104
194278089.jpg,0,12,54,38,2,106
194369363.jpg,7,79,18,1,0,105
1946326263.jpg,0,9,39,56,1,105
1947195937.jpg,0,46,48,5,0,99
19502065.jpg,85,17,0,0,0,102
1966235400.jpg,0,1,51,53,0,105
196734006.jpg,0,1,27,73,2,103
1970440733.jpg,0,17,100,17,0,134
197324620.jpg,1,6,49,44,2,102
1979184408.jpg,0,19,71,13,0,103
198187235.jpg,0,15,46,37,1,99
1987196687.jpg,18,86,5,0,0,109
1988371580.jpg,0,5,42,50,8,105
1990074154.jpg,0,0,12,78,17,107
1990510796.jpg,0,5,91,37,0,133
1992159390.jpg,0,0,46,57,2,105
1993125888.jpg,0,24,60,18,0,102
19943010.jpg,0,2,20,70,15,107
1995190133.jpg,0,0,16,77,9,102
20079130.jpg,1,37,56,8,0,102
200825729.jpg,0,2,48,55,1,106
2017266.jpg,1,10,52,44,1,108
2020522728.jpg,0,6,57,43,0,106
202351926.jpg,0,2,27,68,7,104
202551289.jpg,5,59,35,3,0,102
2034844231.jpg,0,5,80,22,0,107
2035975268.jpg,51,46,6,1,0,104
203950866.jpg,0,2,30,59,7,98
2041755502.jpg,0,0,36,68,1,105
2044507520.jpg,0,0,17,70,22,109
2047083409.jpg,2,32,61,11,0,106
20522527.jpg,0,9,45,47,3,104
2053452455.jpg,0,5,71,32,1,109
2054743275.jpg,0,14,78,15,0,107
2055589084.jpg,1,52,49,2,0,104
205662428.jpg,3,56,39,1,0,99
2058985902.jpg,4,48,47,4,0,103
2059981058.jpg,1,13,67,27,0,108
2060529660.jpg,4,41,64,2,0,111
206294085.jpg,13,81,12,0,0,106
2063421762.jpg,10,55,37,2,0,104
2063914625.jpg,0,37,64,3,0,104
2064478851.jpg,1,46,53,2,0,102
2064690658.jpg,2,51,55,1,0,109
2065542928.jpg,0,10,55,33,4,102
2065722620.jpg,0,2,40,59,2,103
2068650026.jpg,0,3,60,40,0,103
2070418201.jpg,1,34,89,1,0,125
2072843602.jpg,1,7,82,44,2,136
2074092022.jpg,0,1,55,47,0,103
2082936451.jpg,0,3,54,46,4,107
2084725313.jpg,0,1,62,43,1,107
2088433684.jpg,2,75,27,0,0,104
208949930.jpg,0,1,30,69,4,104
2093280771.jpg,3,45,53,3,0,104
2093652366.jpg,2,39,56,7,0,104
2094668596.jpg,0,17,69,24,0,110
2096424103.jpg,0,18,72,13,1,104
2097618827.jpg,4,65,38,3,0,110
2098594651.jpg,28,72,6,0,0,106
2099199686.jpg,0,1,59,45,1,106
2100483102.jpg,2,17,55,30,0,104
2102208013.jpg,0,1,14,83,7,105
2111309017.jpg,0,5,33,63,0,101
2113239475.jpg,1,12,71,23,2,109
2113638482.jpg,1,20,69,13,0,103
2114240861.jpg,0,18,71,12,0,101
2114797362.jpg,0,12,67,21,0,100
211562425.jpg,8,55,34,2,0,99
2115915075.jpg,0,12,74,19,0,105
211603206.jpg,0,5,43,49,2,99
2124048872.jpg,2,29,55,14,0,100
2125272449.jpg,2,32,67,5,0,106
2125535764.jpg,0,18,71,19,0,108
2125600207.jpg,0,1,39,59,2,101
2126677316.jpg,19,106,30,0,0,155
2126890271.jpg,6,41,67,12,0,126
2127908996.jpg,3,73,34,2,0,112
2128879923.jpg,2,81,20,1,0,104
2129246782.jpg,0,4,58,40,1,103
2129680216.jpg,0,2,12,78,8,100
2131254561.jpg,0,54,47,3,0,104
2133766199.jpg,1,30,74,6,0,111
213439801.jpg,30,55,12,1,0,98
2138715193.jpg,0,20,70,17,0,107
2138874780.jpg,0,2,46,45,2,95
213906996.jpg,0,0,7,66,33,106
214064484.jpg,2,20,53,23,1,99
2140758242.jpg,0,2,57,48,0,107
2140864586.jpg,0,5,58,41,1,105
2142428164.jpg,0,1,35,67,5,108
2144290999.jpg,38,61,7,0,0,106
2144963177.jpg,0,5,72,29,0,106
2145860500.jpg,0,6,60,37,1,104
2147067327.jpg,0,1,53,50,0,104
2147811000.jpg,2,37,59,9,0,107
2148143527.jpg,0,9,95,22,0,126
2149719899.jpg,2,50,44,3,0,99
2149726014.jpg,22,65,20,0,0,107
2150291485.jpg,0,21,62,16,0,99
2152767186.jpg,0,3,41,52,5,101
2154184161.jpg,0,19,71,17,0,107
215794898.jpg,1,18,66,19,0,104
2159705303.jpg,3,48,46,7,0,104
2161809899.jpg,0,9,79,17,1,106
2164495332.jpg,2,50,51,3,0,106
2166503846.jpg,0,23,70,9,1,103
2167658722.jpg,0,23,93,18,0,134
2168323029.jpg,0,21,62,18,0,101
2169516596.jpg,0,8,68,33,0,109
2170460897.jpg,1,30,71,5,0,107
2172409998.jpg,1,16,70,17,0,104
2174764653.jpg,0,0,34,67,4,105
2178785463.jpg,0,14,66,24,0,104
2181528959.jpg,0,1,36,64,3,104
2182811741.jpg,0,3,48,44,1,96
2183577836.jpg,3,57,68,2,0,130
218453569.jpg,1,12,46,40,3,102
218457399.jpg,4,48,38,12,2,104
21852937.jpg,1,43,55,10,0,109
2189906236.jpg,0,11,70,22,1,104
2189933975.jpg,2,39,57,9,1,108
2190310.jpg,0,12,58,29,3,102
2191202126.jpg,0,45,60,4,0,109
2191549592.jpg,0,31,86,8,0,125
2191619969.jpg,0,8,74,21,0,103
2191898704.jpg,0,5,63,34,2,104
2194214783.jpg,1,0,23,73,7,104
2195703133.jpg,0,16,79,13,0,108
2196513263.jpg,57,48,2,0,0,107
2197565905.jpg,0,3,43,60,4,110
2197636094.jpg,0,3,44,51,3,101
2198895718.jpg,3,32,55,9,1,100
2199106763.jpg,0,34,55,20,0,109
2199234449.jpg,0,36,62,6,0,104
2199696686.jpg,0,1,28,78,4,111
2201178081.jpg,1,12,69,16,0,98
220183616.jpg,1,42,52,4,0,99
2202105982.jpg,2,61,43,1,0,107
2203797715.jpg,0,0,36,70,2,108
2204368170.jpg,1,39,62,4,0,106
220503608.jpg,15,67,19,1,0,102
2208434983.jpg,10,77,21,0,0,108
2211658928.jpg,0,1,55,72,2,130
2212296403.jpg,0,7,63,40,1,111
2214729676.jpg,15,76,11,0,0,102
2215032826.jpg,0,2,31,71,1,105
2215695798.jpg,0,12,52,37,3,104
2217543976.jpg,0,1,31,73,1,106
2220192526.jpg,0,2,38,56,2,98
2221745311.jpg,3,55,43,1,0,102
2223002938.jpg,0,5,59,36,1,101
2223255997.jpg,1,38,55,6,0,100
222335349.jpg,0,6,45,45,2,98
2224984425.jpg,0,2,56,49,0,107
2225421381.jpg,0,0,23,77,6,106
2225683996.jpg,0,1,38,64,6,109
2227011292.jpg,0,1,40,55,5,101
2231043641.jpg,0,5,75,22,0,102
2231397523.jpg,0,1,54,57,0,112
223186789.jpg,0,15,61,28,1,105
223191871.jpg,7,43,45,8,0,103
2232895391.jpg,0,39,61,6,0,106
2233947320.jpg,0,31,67,4,0,102
2234060892.jpg,16,70,22,0,0,108
2234064642.jpg,0,39,60,7,0,106
2235352888.jpg,0,1,32,65,2,100
2236041996.jpg,5,59,35,0,0,99
2236324282.jpg,0,2,42,57,3,104
2237630871.jpg,0,2,19,69,4,94
2239201463.jpg,0,0,48,54,2,104
2239403255.jpg,0,1,31,63,8,103
2239600333.jpg,0,11,61,29,0,101
2239987680.jpg,8,77,20,0,0,105
224076897.jpg,0,12,45,46,0,103
2243689404.jpg,0,7,59,43,2,111
2243706700.jpg,1,17,65,22,0,105
2249130247.jpg,0,0,33,70,3,106
2250728053.jpg,0,0,17,81,4,102
2251792086.jpg,0,17,88,29,0,134
22533278.jpg,0,29,61,13,1,104
2255689742.jpg,0,8,72,22,0,102
2255948084.jpg,0,1,23,74,4,102
2256741921.jpg,4,33,58,11,0,106
2259747766.jpg,0,17,82,8,0,107
2260527943.jpg,2,12,62,28,0,104
2261421219.jpg,0,2,24,67,8,101
2263434837.jpg,0,0,25,74,9,108
226477214.jpg,1,51,42,5,0,99
2264946914.jpg,6,48,50,5,0,109
2266672191.jpg,0,10,76,21,0,107
2268779821.jpg,2,37,55,8,0,102
2269141846.jpg,1,15,68,16,0,100
2275633566.jpg,2,52,50,2,0,106
2276757352.jpg,0,5,80,19,1,105
2276823208.jpg,0,2,48,55,0,105
2279663213.jpg,0,3,62,37,0,102
2280116666.jpg,7,61,30,3,0,101
2280432289.jpg,0,51,48,5,0,104
2280531345.jpg,15,61,33,2,0,111
2280668053.jpg,1,34,63,9,0,107
22848476.jpg,0,12,70,25,2,109
2285382083.jpg,0,2,64,40,0,106
2285789022.jpg,0,24,71,8,0,103
228617373.jpg,8,59,31,4,0,102
2286627596.jpg,0,60,48,1,0,109
2286659351.jpg,0,6,60,44,1,111
2287163032.jpg,2,8,59,30,1,100
2292384520.jpg,0,4,56,42,0,102
2292770854.jpg,0,10,75,19,0,104
2293775114.jpg,3,40,58,9,0,110
229400288.jpg,1,35,61,9,0,106
22947511.jpg,52,49,3,0,0,104
2295329994.jpg,9,78,17,0,0,104
2295909322.jpg,0,1,42,57,1,101
2297923850.jpg,0,17,75,14,0,106
2298149104.jpg,1,6,51,44,0,102
2298165172.jpg,0,2,63,34,1,100
2298963655.jpg,0,3,42,62,0,107
2300197705.jpg,2,11,54,36,1,104
2301461383.jpg,0,12,66,23,0,101
2303343292.jpg,0,5,92,29,0,126
2304159288.jpg,2,23,90,25,0,140
2304572915.jpg,4,58,41,2,0,105
2305236722.jpg,16,71,17,0,0,104
2306462251.jpg,6,64,35,3,0,108
2308986836.jpg,0,3,53,43,0,99
2310631117.jpg,5,65,29,1,0,100
231161527.jpg,0,13,69,17,0,99
2311702728.jpg,5,44,51,3,0,103
2311738871.jpg,4,30,64,6,0,104
2313971368.jpg,0,0,43,58,3,104
2314346258.jpg,0,14,73,18,0,105
2314745999.jpg,0,6,47,51,1,105
2317296071.jpg,4,60,39,1,0,104
2318824279.jpg,0,7,72,30,1,110
2319588792.jpg,0,4,49,51,1,105
2322053874.jpg,0,0,10,82,18,110
2322154086.jpg,0,13,77,11,0,101
2322493147.jpg,0,5,35,60,1,101
232327907.jpg,1,17,52,32,1,103
2323279407.jpg,0,38,68,4,0,110
2323828778.jpg,2,60,68,2,0,132
2324511288.jpg,4,54,40,4,0,102
2325353113.jpg,52,49,6,0,0,107
2329115753.jpg,2,10,81,8,0,101
2329258631.jpg,7,67,29,0,0,103
2329975863.jpg,1,14,76,19,1,111
233025659.jpg,0,4,49,49,3,105
233045606.jpg,0,5,52,48,1,106
233045618.jpg,0,47,47,4,0,98
2331420998.jpg,2,29,65,9,0,105
2332998569.jpg,53,45,2,0,0,100
2333476039.jpg,27,70,8,0,0,105
2337030121.jpg,0,1,33,68,1,103
23371433.jpg,3,44,45,11,1,104
2338832331.jpg,0,26,46,33,1,106
2339673410.jpg,5,78,21,0,0,104
2339723901.jpg,0,2,54,48,0,104
2341720836.jpg,0,6,82,40,1,129
2342012928.jpg,0,0,36,68,3,107
2344211137.jpg,0,0,46,55,3,104
2345921877.jpg,0,25,116,12,0,153
2347131131.jpg,0,10,63,36,0,109
234944177.jpg,0,3,28,67,7,105
2349676135.jpg,9,59,32,7,1,108
2350031609.jpg,2,52,44,3,0,101
2355192446.jpg,1,5,52,48,1,107
2355891811.jpg,5,60,36,1,0,102
2360058082.jpg,12,86,6,0,0,104
2361724609.jpg,3,54,42,11,0,110
2362202039.jpg,0,1,33,78,3,115
2362957665.jpg,0,1,37,63,2,103
2363413290.jpg,1,26,65,9,0,101
2363717244.jpg,0,2,23,71,8,104
2364482871.jpg,0,9,76,21,0,106
2364901003.jpg,2,51,76,2,0,131
2365109175.jpg,0,20,78,5,0,103
2365855574.jpg,0,5,64,39,1,109
2366273919.jpg,12,63,28,1,0,104
2366307779.jpg,0,7,68,29,3,107
2367261033.jpg,38,58,12,0,0,108
2367765365.jpg,2,43,50,12,0,107
2371655336.jpg,2,53,42,7,0,104
2371669291.jpg,0,2,56,47,2,107
2372696116.jpg,0,5,69,29,0,103
2375572237.jpg,0,4,74,52,0,130
2376113642.jpg,4,71,30,0,0,105
2376602512.jpg,2,17,77,12,0,108
2378761573.jpg,0,9,54,43,0,106
2380962902.jpg,0,1,40,58,0,99
2381196755.jpg,19,67,14,1,0,101
2383953966.jpg,0,6,57,45,0,108
2389241544.jpg,0,23,65,14,0,102
239029957.jpg,0,3,29,61,10,103
2393187912.jpg,7,64,33,3,0,107
240236110.jpg,0,2,30,62,8,102
2403326474.jpg,0,20,77,13,0,110
2405333928.jpg,1,22,74,12,0,109
2405495711.jpg,2,39,55,9,0,105
240689125.jpg,2,15,55,33,1,106
2407446104.jpg,0,7,55,46,0,108
2409675838.jpg,0,72,39,2,0,113
2410920428.jpg,0,0,14,84,10,108
2410933503.jpg,0,0,31,72,6,109
2413968824.jpg,22,53,24,1,0,100
2415334988.jpg,3,50,48,2,0,103
2415583702.jpg,21,56,25,4,0,106
2415943373.jpg,0,1,41,57,2,101
2416231204.jpg,0,12,70,23,1,106
2417107784.jpg,0,5,62,34,1,102
2418067534.jpg,7,78,28,0,0,113
2421141390.jpg,7,59,33,2,0,101
2421862008.jpg,0,0,17,93,3,113
2422029745.jpg,8,82,10,1,0,101
2422172125.jpg,5,64,33,5,0,107
242395156.jpg,56,40,5,0,0,101
242503451.jpg,38,55,7,1,0,101
2425646672.jpg,0,19,75,16,0,110
2426998006.jpg,0,9,75,22,0,106
2428050358.jpg,1,14,100,24,0,139
2429849599.jpg,0,8,59,33,2,102
2431828879.jpg,1,18,64,23,1,107
2433641656.jpg,0,16,76,16,2,110
2434624532.jpg,11,97,29,0,0,137
2437860365.jpg,0,1,34,66,0,101
2444482022.jpg,1,47,55,3,0,106
244484608.jpg,40,54,5,0,0,99
2444937456.jpg,0,1,51,60,1,113
2447131470.jpg,0,24,67,11,0,102
2447797924.jpg,0,47,51,1,0,99
2448776548.jpg,2,9,70,28,1,110
2451920772.jpg,0,4,50,50,3,107
2455942045.jpg,0,7,80,18,1,106
2459843879.jpg,2,6,46,50,1,105
2459857216.jpg,0,0,46,92,1,139
2460847286.jpg,7,56,41,3,1,108
2461703201.jpg,0,5,48,50,0,103
246188030.jpg,71,31,3,0,0,105
2464934588.jpg,0,48,50,2,0,100
2465673065.jpg,3,47,45,3,0,98
2466673147.jpg,0,1,38,66,2,107
2471109874.jpg,38,66,5,1,0,110
2473676566.jpg,45,58,2,0,0,105
2473938827.jpg,1,4,54,50,0,109
2474265369.jpg,6,38,47,9,1,101
2474539087.jpg,0,12,81,9,0,102
2475938786.jpg,12,63,30,3,0,108
2476813465.jpg,0,7,78,16,0,101
2477552466.jpg,26,69,13,0,0,108
2478250944.jpg,0,18,70,39,1,128
2479736959.jpg,0,0,52,49,1,102
2481588554.jpg,65,38,5,0,0,108
2486040810.jpg,0,9,73,31,0,113
2488865108.jpg,0,1,51,51,5,108
2489035588.jpg,3,50,47,2,0,102
2489209226.jpg,0,17,72,14,0,103
2490462635.jpg,0,13,63,25,0,101
2491353954.jpg,1,37,59,7,0,104
2492228578.jpg,11,65,28,3,0,107
2495556421.jpg,0,0,16,80,6,102
2495772957.jpg,2,39,63,7,0,111
249590486.jpg,0,10,51,42,1,104
2496466506.jpg,45,53,5,0,0,103
2500167386.jpg,0,0,15,87,12,114
2500618710.jpg,0,3,34,62,3,102
2501256504.jpg,1,34,61,8,0,104
2502332369.jpg,0,3,60,43,0,106
2503231447.jpg,0,19,65,20,0,104
2503685415.jpg,0,15,74,17,1,107
2503869220.jpg,1,45,46,7,1,100
2504686366.jpg,0,0,45,65,1,111
2508139577.jpg,18,47,40,2,0,107
2508976529.jpg,0,0,26,81,0,107
2510458503.jpg,0,0,38,59,9,106
2512779647.jpg,0,19,63,29,0,111
2515829883.jpg,0,1,34,68,2,105
2517368566.jpg,3,47,48,7,0,105
2517718928.jpg,0,2,49,65,7,123
2519235976.jpg,8,76,21,0,0,105
251925288.jpg,13,63,29,1,0,106
2519479147.jpg,0,1,61,46,3,111
25239707.jpg,0,0,10,67,25,102
252435496.jpg,7,67,34,0,0,108
2527050529.jpg,0,0,58,66,6,130
2528064728.jpg,1,6,81,14,0,102
2529798721.jpg,1,45,51,6,1,104
2530204171.jpg,0,0,27,74,5,106
2532088252.jpg,0,0,42,71,1,114
253771260.jpg,4,58,29,8,0,99
2537782042.jpg,0,3,60,39,1,103
2538038277.jpg,0,6,31,68,4,109
2539036531.jpg,0,1,47,54,4,106
2539083530.jpg,0,15,72,14,0,101
2539097876.jpg,0,11,68,26,1,106
2539818768.jpg,5,63,56,1,0,125
2540676775.jpg,0,52,53,1,0,106
2542492471.jpg,4,51,51,3,0,109
2545877303.jpg,1,46,44,5,0,96
2547820942.jpg,1,1,31,67,2,102
2549004146.jpg,1,52,48,5,0,106
254969296.jpg,0,27,49,23,0,99
255478501.jpg,68,29,2,0,0,99
2555211479.jpg,0,22,75,7,0,104
2555644998.jpg,0,6,46,49,0,101
2557729909.jpg,0,0,36,88,2,126
255857546.jpg,0,2,25,66,9,102
255984640.jpg,3,37,57,9,0,106
255985226.jpg,22,69,12,0,0,103
2562592972.jpg,5,60,34,2,0,101
2564368557.jpg,0,6,54,38,3,101
2567523621.jpg,1,12,74,25,1,113
2568268182.jpg,0,27,61,13,0,101
2569693875.jpg,0,0,28,81,4,113
2569774614.jpg,7,59,35,4,0,105
2569803000.jpg,0,4,88,16,1,109
2569997123.jpg,0,1,45,55,0,101
2570828036.jpg,0,1,45,66,0,112
257114018.jpg,6,35,41,24,0,106
2571521736.jpg,0,12,69,23,1,105
2574200121.jpg,0,16,72,15,1,104
25742613.jpg,38,62,3,1,0,104
257457837.jpg,3,56,41,5,0,105
2575730355.jpg,0,12,65,29,0,106
2576250575.jpg,0,30,66,15,0,111
2578696926.jpg,1,0,24,79,3,107
2578890441.jpg,0,2,42,61,2,107
2579041082.jpg,0,5,66,35,0,106
2580252988.jpg,2,16,61,25,0,104
2584408449.jpg,0,0,26,75,4,105
258502837.jpg,1,29,46,22,0,98
2585752058.jpg,0,10,58,30,1,99
2585795694.jpg,1,27,64,13,0,105
2588726621.jpg,0,3,42,56,0,101
2588767665.jpg,0,7,61,36,0,104
258893048.jpg,2,15,53,33,2,105
2589128365.jpg,0,23,65,11,2,101
2590631506.jpg,0,1,21,78,10,110
2593384818.jpg,7,73,25,1,0,106
2596393826.jpg,0,18,68,19,0,105
2601194994.jpg,0,18,76,11,0,105
2601219815.jpg,3,34,63,9,0,109
2602273170.jpg,2,38,56,9,0,105
260267679.jpg,0,1,34,67,2,104
2602795550.jpg,9,66,25,2,0,102
2603439486.jpg,0,14,72,21,0,107
2604683646.jpg,0,5,65,30,1,101
2608308562.jpg,0,0,54,48,1,103
2612353606.jpg,0,2,13,85,3,103
2614925521.jpg,11,62,27,2,0,102
2615955728.jpg,0,4,49,43,6,102
261641635.jpg,0,2,16,74,14,106
2619769686.jpg,0,0,36,67,2,105
2620467173.jpg,1,19,79,13,0,112
2620618611.jpg,0,5,43,51,5,104
262123064.jpg,0,24,65,22,0,111
2621420457.jpg,5,29,59,13,0,106
2622466873.jpg,0,13,75,16,0,104
2624809780.jpg,0,9,75,23,2,109
2624882684.jpg,0,2,44,61,3,110
2627264031.jpg,0,0,40,60,3,103
2630235144.jpg,0,10,75,16,2,103
2631446955.jpg,0,0,17,74,17,108
2631646011.jpg,0,0,52,57,1,110
2633540206.jpg,0,0,41,62,4,107
2634194915.jpg,2,43,57,2,0,104
26344318.jpg,14,51,33,6,0,104
2634922777.jpg,8,54,38,3,0,103
2636294461.jpg,0,2,45,61,3,111
2636589178.jpg,1,31,48,29,0,109
2638753115.jpg,4,66,35,1,0,106
2639149999.jpg,0,3,55,48,0,106
2640025600.jpg,2,48,79,8,1,138
264173063.jpg,5,66,36,3,0,110
2641860474.jpg,0,44,51,6,0,101
2642678784.jpg,0,6,79,24,0,109
2643679552.jpg,0,0,41,67,1,109
2646059323.jpg,0,6,47,53,3,109
264903403.jpg,0,1,46,56,1,104
2649433967.jpg,9,68,28,2,0,107
2649625286.jpg,0,2,53,51,2,108
2650447326.jpg,28,91,37,1,0,157
2652397944.jpg,0,0,46,57,0,103
2653425342.jpg,0,13,62,34,1,110
2654797164.jpg,0,3,45,48,2,98
2655416178.jpg,0,8,59,34,1,102
2655543598.jpg,0,0,33,69,3,105
2656455723.jpg,1,34,68,10,0,113
2657101675.jpg,0,7,69,25,1,102
2659313316.jpg,0,2,46,55,4,107
2664892520.jpg,1,17,102,15,0,135
2667565926.jpg,0,2,41,61,1,105
2670033779.jpg,2,8,85,12,0,107
2670820241.jpg,2,45,48,5,0,100
2672397400.jpg,0,4,39,54,4,101
2676057580.jpg,0,1,25,68,7,101
2676808752.jpg,5,56,45,4,0,110
2676837522.jpg,1,9,59,28,0,97
2678740354.jpg,0,11,73,22,0,106
2679224314.jpg,43,61,4,0,0,108
2680180441.jpg,6,89,42,1,0,138
268066639.jpg,0,13,83,12,0,108
2683241926.jpg,1,3,38,60,4,106
26842976.jpg,6,49,45,6,0,106
26847054.jpg,0,11,61,28,1,101
2688019250.jpg,0,14,83,10,0,107
2688943738.jpg,2,25,63,10,1,101
2688944098.jpg,10,76,19,0,0,105
268926698.jpg,0,18,73,14,0,105
2690466413.jpg,3,30,63,11,0,107
2692538398.jpg,0,11,72,23,0,106
2693336679.jpg,1,51,47,2,0,101
2693433475.jpg,0,10,70,22,1,103
269509962.jpg,0,6,72,24,0,102
2696730288.jpg,1,4,44,49,3,101
2698401109.jpg,0,0,29,67,5,101
2700852747.jpg,0,15,58,26,1,100
2702264162.jpg,0,7,74,28,1,110
2703329173.jpg,0,3,52,52,0,107
2703740653.jpg,0,4,69,26,0,99
2704389795.jpg,0,2,26,71,7,106
2704811.jpg,1,28,66,9,0,104
2706980942.jpg,0,0,42,57,2,101
2709928858.jpg,0,24,61,18,0,103
271262860.jpg,1,6,75,31,0,113
2713735764.jpg,0,31,97,11,0,139
2715023572.jpg,0,2,31,73,1,107
2715181629.jpg,0,7,52,46,0,105
2716631816.jpg,13,83,10,1,0,107
271837545.jpg,0,0,20,71,10,101
2718449902.jpg,0,60,42,1,0,103
2720757001.jpg,7,61,34,0,0,102
272115602.jpg,1,13,64,27,0,105
2722913532.jpg,1,6,67,25,1,100
272411695.jpg,46,59,2,0,0,107
2725001053.jpg,7,78,23,0,0,108
2725180694.jpg,0,1,35,73,2,111
272518935.jpg,0,8,70,32,0,110
2725531194.jpg,0,0,45,66,0,111
2725531293.jpg,1,27,66,10,0,104
2726553628.jpg,0,2,71,34,0,107
2726774995.jpg,13,76,18,1,0,108
2730274502.jpg,0,41,67,1,0,109
2730850462.jpg,0,3,70,29,1,103
273181633.jpg,0,0,56,46,1,103
2734143216.jpg,0,3,53,45,6,107
2736161037.jpg,5,31,65,6,0,107
2737304398.jpg,0,16,75,9,0,100
273844105.jpg,0,0,12,80,10,102
2739007601.jpg,0,21,67,8,0,96
2739038267.jpg,0,0,27,68,13,108
2741340609.jpg,1,6,54,47,2,110
2741661469.jpg,0,4,53,50,0,107
2741854107.jpg,10,65,33,2,0,110
2742066850.jpg,14,75,14,2,0,105
274223521.jpg,4,66,28,2,0,100
2743703757.jpg,0,17,78,6,0,101
274390572.jpg,5,59,44,1,1,110
2745252477.jpg,0,5,48,46,2,101
2746983219.jpg,0,3,48,52,0,103
2747111058.jpg,1,3,43,54,1,102
2748301393.jpg,3,52,40,7,0,102
2748370097.jpg,2,12,63,21,4,102
2749377637.jpg,0,10,79,17,1,107
2753587179.jpg,1,4,63,26,1,95
2753606061.jpg,0,10,80,37,0,127
2756512177.jpg,0,16,81,11,0,108
2759049308.jpg,1,35,64,2,0,102
275983561.jpg,1,25,67,10,0,103
276009784.jpg,0,5,64,39,0,108
2761179748.jpg,0,8,60,41,1,110
2762549217.jpg,0,2,45,56,3,106
2764211276.jpg,5,79,25,2,0,111
2764419323.jpg,0,14,77,21,0,112
2764641436.jpg,0,0,49,55,0,104
276570133.jpg,1,63,43,2,0,109
276590560.jpg,3,49,47,4,0,103
2766412345.jpg,6,58,41,1,0,106
2768178889.jpg,1,47,52,4,0,104
2770155406.jpg,0,6,68,32,0,106
2771131265.jpg,0,2,57,45,1,105
277244271.jpg,0,27,61,9,0,97
277758418.jpg,1,13,70,21,1,106
2778039171.jpg,0,2,38,62,3,105
2779185055.jpg,0,23,73,13,0,109
2780719978.jpg,0,9,88,28,1,126
278235103.jpg,2,55,45,5,0,107
2785267250.jpg,0,1,28,69,2,100
2785774595.jpg,0,9,65,26,2,102
278636331.jpg,0,12,61,28,2,103
2786566950.jpg,5,76,26,0,0,107
27896611.jpg,0,18,58,26,2,104
2789763994.jpg,0,0,43,57,1,101
2790138273.jpg,0,6,56,36,0,98
2795083224.jpg,0,6,45,59,2,112
2796774323.jpg,0,0,28,66,12,106
2798808586.jpg,0,4,58,40,0,102
2799264783.jpg,0,1,38,66,4,109
2799634889.jpg,0,3,65,32,2,102
280028696.jpg,8,77,26,0,0,111
2800893640.jpg,29,62,10,0,0,101
2801033102.jpg,1,45,54,8,0,108
2806740564.jpg,0,2,44,58,3,107
2807676440.jpg,0,2,66,33,0,101
2807762234.jpg,0,0,43,58,6,107
2808063507.jpg,3,62,40,0,0,105
2808265543.jpg,6,57,58,5,0,126
2808286292.jpg,0,0,32,68,5,105
2809274597.jpg,2,51,51,4,0,108
2811625726.jpg,1,1,29,76,7,114
2815247737.jpg,2,42,50,6,0,100
281609508.jpg,0,12,63,28,1,104
28173586.jpg,0,5,55,42,1,103
2817883212.jpg,0,0,18,70,12,100
2818844013.jpg,0,1,43,61,0,105
2819296433.jpg,1,33,62,10,0,106
2819647550.jpg,0,3,57,36,0,96
2822019435.jpg,0,3,47,57,0,107
2823812300.jpg,1,7,58,44,1,111
2824487894.jpg,9,78,16,1,0,104
2824866912.jpg,0,10,52,42,1,105
282730228.jpg,0,14,67,22,1,104
2828824744.jpg,1,50,52,1,0,104
28311109.jpg,86,16,0,0,0,102
2832980159.jpg,0,2,40,62,2,106
2833068342.jpg,0,1,53,50,0,104
2833148596.jpg,0,5,49,57,1,112
2835381273.jpg,4,49,48,5,0,106
2836089223.jpg,4,60,38,6,0,108
2836927819.jpg,0,0,12,86,11,109
2837843986.jpg,9,78,39,0,0,126
2838554535.jpg,2,56,42,4,0,104
2838590977.jpg,0,21,80,4,0,105
2839454152.jpg,7,70,32,1,0,110
2839494557.jpg,0,1,43,61,2,107
2840937282.jpg,7,61,30,0,0,98
2841048687.jpg,0,11,84,12,1,108
2841924891.jpg,0,1,52,50,0,103
2844388238.jpg,0,5,52,42,2,101
2844802224.jpg,2,21,55,27,0,105
2848340403.jpg,1,23,80,9,1,114
2848415190.jpg,0,2,43,57,2,104
2848420274.jpg,1,1,60,43,1,106
2848518668.jpg,0,4,58,39,0,101
285149839.jpg,0,60,77,2,0,139
2851510265.jpg,0,5,66,31,0,102
285183593.jpg,25,70,8,2,0,105
2852195444.jpg,0,8,44,47,2,101
2852488757.jpg,0,1,43,65,2,111
2855163439.jpg,0,24,94,10,0,128
2856053454.jpg,8,82,11,0,0,101
2857618850.jpg,0,1,31,71,3,106
2858136334.jpg,6,64,36,2,0,108
2858839896.jpg,0,7,64,34,0,105
2859973577.jpg,0,2,47,81,1,131
2861346409.jpg,0,6,54,40,2,102
286576891.jpg,1,27,68,5,0,101
2866097268.jpg,2,32,62,7,0,103
2866556638.jpg,0,26,72,8,0,106
2867718050.jpg,4,81,24,0,0,109
2868335466.jpg,0,14,75,12,0,101
2868514181.jpg,0,32,68,7,0,107
2871570084.jpg,0,2,58,45,1,106
2871745051.jpg,0,4,12,77,18,111
287350518.jpg,3,77,31,0,0,111
2876226509.jpg,1,53,50,1,0,105
288113726.jpg,34,67,10,0,0,111
288435225.jpg,1,31,76,2,0,110
2886173632.jpg,3,28,67,5,0,103
2887792801.jpg,0,15,74,21,0,110
2888444557.jpg,0,4,74,29,0,107
2889093136.jpg,0,4,61,39,2,106
288926242.jpg,0,17,71,17,1,106
2889734029.jpg,0,0,29,73,6,108
2890317632.jpg,1,33,58,10,0,102
2893674566.jpg,0,3,46,81,1,131
289395722.jpg,7,42,47,2,0,98
289462174.jpg,12,75,17,0,0,104
2897238920.jpg,1,56,43,6,0,106
2899446484.jpg,8,58,41,3,0,110
2901332011.jpg,0,6,60,38,2,106
290161904.jpg,0,4,43,58,2,107
2902284957.jpg,0,1,28,76,4,109
2903155533.jpg,0,7,77,19,2,105
2904337110.jpg,12,62,38,0,0,112
2904731239.jpg,0,4,59,41,0,104
2905127622.jpg,0,6,71,26,0,103
2905606337.jpg,0,7,68,26,0,101
2906250648.jpg,0,43,59,2,0,104
2906852026.jpg,0,1,49,61,1,112
2906945782.jpg,0,4,56,50,0,110
2907072293.jpg,37,65,8,0,0,110
290776828.jpg,0,1,34,65,1,101
290784782.jpg,0,3,35,62,6,106
2908299910.jpg,1,27,71,11,1,111
2908654044.jpg,2,53,48,3,0,106
2909358760.jpg,0,1,44,58,3,106
2910495331.jpg,0,1,61,40,1,103
2910515798.jpg,1,5,42,50,3,101
2910782740.jpg,0,10,72,27,0,109
2916069086.jpg,0,1,55,62,0,118
2916773975.jpg,0,5,51,48,0,104
2918475321.jpg,0,35,63,7,0,105
2920995979.jpg,0,29,69,7,0,105
2923794448.jpg,0,1,44,59,2,106
2924727768.jpg,1,1,50,53,3,108
2926374384.jpg,0,3,44,57,1,105
2927008302.jpg,0,12,62,26,2,102
2928622708.jpg,0,11,75,20,0,106
2931243331.jpg,0,2,78,49,1,130
2931922629.jpg,0,5,59,41,0,105
2932540851.jpg,0,0,56,53,0,109
2933417983.jpg,9,58,40,3,0,110
2933544143.jpg,0,29,69,8,0,106
2937190977.jpg,0,0,36,67,2,105
2937238676.jpg,1,18,68,15,0,102
2937429297.jpg,0,32,59,9,0,100
2938430307.jpg,0,2,35,64,2,103
2939787669.jpg,0,1,47,59,0,107
2941933060.jpg,0,0,19,86,9,114
2943372707.jpg,0,2,57,45,2,106
2944165349.jpg,5,45,46,5,0,101
2946225988.jpg,7,67,28,1,0,103
2946661592.jpg,0,3,36,63,5,107
2948923084.jpg,0,0,28,72,6,106
2949029930.jpg,4,84,41,4,0,133
2951011449.jpg,0,0,44,56,2,102
2951329736.jpg,0,1,29,71,7,108
2951685771.jpg,0,0,30,79,3,112
2952066894.jpg,0,3,41,53,3,100
2952908030.jpg,0,22,75,6,1,104
2953741163.jpg,2,42,55,10,0,109
2954125895.jpg,0,0,21,75,8,104
2954406623.jpg,17,81,15,0,0,113
2956548148.jpg,8,79,16,1,0,104
2957895882.jpg,4,51,82,2,1,140
2958115632.jpg,0,0,16,81,13,110
295960855.jpg,0,1,42,58,4,105
2960552821.jpg,16,77,8,0,0,101
2962584804.jpg,0,10,62,35,0,107
296426748.jpg,10,87,13,0,0,110
2964711556.jpg,0,3,36,59,5,103
2964746234.jpg,3,55,41,2,0,101
2965834083.jpg,0,0,17,83,6,106
2967177700.jpg,0,25,62,19,0,106
296739390.jpg,0,16,72,25,1,114
2971073872.jpg,0,26,73,5,0,104
2971372651.jpg,0,1,57,69,1,128
2973164436.jpg,6,69,33,1,0,109
2974085281.jpg,1,52,62,3,0,118
2975238945.jpg,0,1,32,79,1,113
2976379229.jpg,0,0,27,73,6,106
2977820017.jpg,0,5,71,35,0,111
2978991004.jpg,0,28,61,17,1,107
2979597587.jpg,1,34,62,7,0,104
2980838635.jpg,0,4,60,46,0,110
2982904736.jpg,0,0,26,77,2,105
298323953.jpg,1,6,75,19,0,101
298392087.jpg,0,1,59,41,0,101
2985434942.jpg,0,28,62,11,0,101
2986131608.jpg,0,24,70,11,0,105
2988609766.jpg,0,21,79,8,0,108
2990464677.jpg,0,1,36,72,2,111
2990600386.jpg,1,22,66,18,0,107
2991438895.jpg,2,69,51,0,0,122
299211567.jpg,7,71,23,1,0,102
2992631389.jpg,0,8,66,30,1,105
299519765.jpg,0,1,31,71,3,106
2998270477.jpg,4,42,60,3,0,109
2999079951.jpg,9,61,33,4,0,107
3000370105.jpg,0,7,66,39,0,112
3001984740.jpg,5,48,53,5,0,111
3003071617.jpg,0,0,51,54,1,106
3004729679.jpg,0,4,40,58,4,106
3005225950.jpg,0,1,24,73,3,101
3005232085.jpg,1,25,65,15,0,106
30054528.jpg,0,2,40,64,1,107
3006180799.jpg,0,10,86,10,0,106
3007216990.jpg,2,57,48,0,0,107
3009167692.jpg,0,2,28,64,5,99
3010841196.jpg,10,42,43,6,0,101
301104017.jpg,0,1,28,72,9,110
3011247965.jpg,2,23,46,34,0,105
3012507882.jpg,0,28,72,2,0,102
3013640771.jpg,0,1,41,61,2,105
3014660789.jpg,0,0,35,63,4,102
3014908112.jpg,0,7,41,60,3,111
3015139450.jpg,0,34,62,7,0,103
3016703765.jpg,0,1,45,56,1,103
3016815898.jpg,1,35,56,14,0,106
3017896883.jpg,31,71,5,0,0,107
3018181041.jpg,0,29,69,9,0,107
3020768905.jpg,0,2,71,57,0,130
3020941119.jpg,0,29,66,6,0,101
3021480593.jpg,0,0,21,75,11,107
3021647597.jpg,0,3,48,51,0,102
3021659624.jpg,3,20,60,26,1,110
3022463774.jpg,0,2,36,65,4,107
3022996908.jpg,0,7,73,19,3,102
3024891214.jpg,0,1,33,63,3,100
3025565947.jpg,0,0,34,75,0,109
3026154930.jpg,0,10,72,24,1,107
302681636.jpg,0,17,70,24,0,111
3026852045.jpg,0,0,42,55,4,101
3032057861.jpg,0,0,51,46,5,102
3033284037.jpg,23,69,14,0,0,106
3034148847.jpg,0,2,55,52,3,112
3035737878.jpg,1,33,70,8,0,112
3038029410.jpg,1,16,68,25,0,110
3038577350.jpg,0,1,35,67,2,105
3039024.jpg,0,45,48,8,1,102
3040037970.jpg,0,1,22,70,12,105
3043517594.jpg,0,2,60,39,2,103
3044304939.jpg,0,11,78,18,0,107
3045035343.jpg,0,3,78,45,1,127
304760277.jpg,0,1,34,63,2,100
3047954017.jpg,0,0,34,73,1,108
3048478105.jpg,0,0,30,76,3,109
3048498691.jpg,0,17,90,20,0,127
3048643650.jpg,0,18,101,10,0,129
3049913075.jpg,0,1,64,71,1,137
3050837263.jpg,0,17,79,11,0,107
3051112804.jpg,15,48,34,7,0,104
3051623040.jpg,2,28,69,5,0,104
3052939128.jpg,0,1,34,62,7,104
3059406578.jpg,0,12,95,32,0,139
306264588.jpg,30,74,6,0,0,110
306315468.jpg,5,72,22,1,0,100
3067436148.jpg,6,79,23,1,0,109
3067455040.jpg,0,45,63,5,0,113
3068655528.jpg,0,11,74,23,1,109
306909339.jpg,2,41,56,5,0,104
3069379747.jpg,0,6,68,30,1,105
3070894795.jpg,4,66,33,6,0,109
3071201670.jpg,0,32,57,12,0,101
3072804517.jpg,1,6,48,52,1,108
3073021963.jpg,0,41,58,6,0,105
3073780494.jpg,0,16,69,17,0,102
3073970642.jpg,0,0,49,57,2,108
3074454678.jpg,0,5,72,30,1,108
307525026.jpg,0,6,65,39,1,111
3075864902.jpg,40,63,5,0,0,108
3076588969.jpg,0,10,55,43,0,108
3077228870.jpg,6,61,41,0,0,108
3077416434.jpg,0,4,48,48,2,102
3077626117.jpg,25,76,12,0,0,113
3078114304.jpg,31,61,13,0,0,105
3078217018.jpg,4,31,65,3,0,103
3078720945.jpg,0,34,57,8,1,100
3084516747.jpg,4,84,21,0,0,109
3084860790.jpg,60,37,6,0,0,103
3085307148.jpg,1,25,63,19,1,109
3086003946.jpg,0,29,75,4,0,108
3087855667.jpg,1,38,60,4,0,103
3090534929.jpg,6,53,42,5,0,106
3091624267.jpg,90,22,1,0,0,113
3092999912.jpg,10,63,22,7,0,102
3093374173.jpg,1,31,61,16,1,110
3093435000.jpg,0,0,28,77,3,108
3094633355.jpg,1,11,63,27,0,102
3094978642.jpg,10,67,24,3,0,104
3099787122.jpg,0,3,74,33,0,110
3100238639.jpg,1,18,58,24,1,102
3100436628.jpg,0,12,63,26,1,102
3102411945.jpg,2,9,69,19,0,99
3102604471.jpg,0,4,77,25,0,106
310467976.jpg,0,1,22,79,8,110
3105942236.jpg,0,0,76,31,0,107
3105967281.jpg,3,14,78,19,0,114
3106852276.jpg,0,3,38,60,5,106
3107236272.jpg,3,51,46,7,0,107
3107928091.jpg,0,29,61,9,1,100
3108798537.jpg,0,13,68,20,0,101
3108925603.jpg,0,0,45,55,5,105
3109009017.jpg,0,0,52,54,3,109
3109733480.jpg,0,0,7,79,20,106
3111479555.jpg,8,53,36,6,0,103
3112707699.jpg,10,81,38,0,0,129
3112828024.jpg,0,6,69,31,2,108
3114317948.jpg,0,6,77,24,0,107
3115128591.jpg,3,18,65,14,0,100
3115284513.jpg,8,73,31,1,0,113
3115828038.jpg,21,70,12,0,0,103
3116503568.jpg,2,43,61,3,0,109
3117619556.jpg,3,34,88,8,0,133
3117729596.jpg,0,21,77,6,0,104
3118054377.jpg,0,5,63,37,1,106
3118439925.jpg,0,5,57,41,0,103
3118885310.jpg,0,7,61,35,0,103
311996877.jpg,6,34,60,9,0,109
3120415423.jpg,0,8,83,32,0,123
3121612010.jpg,0,10,83,14,0,107
3124199543.jpg,33,57,14,3,0,107
3125804438.jpg,0,12,74,22,0,108
312749227.jpg,0,1,23,71,11,106
3127532138.jpg,0,0,51,55,2,108
31286602.jpg,0,2,17,62,27,108
3128928410.jpg,0,3,28,67,3,101
3129387328.jpg,14,66,22,2,0,104
3129647217.jpg,0,0,15,85,4,104
3130211082.jpg,0,0,21,73,8,102
3130276162.jpg,5,44,52,6,0,107
3131665013.jpg,1,24,67,10,0,102
3132046766.jpg,0,11,48,42,3,104
3132085493.jpg,0,1,45,67,1,114
3132104449.jpg,0,3,33,63,0,99
3132669524.jpg,15,79,19,0,0,113
313424539.jpg,0,0,26,75,7,108
313550822.jpg,0,11,74,17,0,102
3136368482.jpg,0,28,71,2,0,101
313650765.jpg,3,52,51,4,0,110
3137057232.jpg,0,32,74,3,1,110
3138088232.jpg,0,7,60,41,0,108
3138790639.jpg,0,2,44,57,5,108
3141055360.jpg,0,16,79,13,0,108
3141860810.jpg,0,3,39,61,3,106
3142311257.jpg,0,10,62,33,0,105
3146365512.jpg,0,1,21,72,8,102
3146477274.jpg,0,32,75,4,0,111
3146801905.jpg,6,66,33,3,0,108
3147028593.jpg,0,33,63,5,0,101
3147348702.jpg,2,42,70,7,0,121
3147416579.jpg,34,46,17,3,0,100
3147925879.jpg,0,4,82,47,0,133
3147927973.jpg,0,11,82,16,0,109
3148698494.jpg,0,38,54,9,0,101
31490353.jpg,0,10,52,39,2,103
3149433848.jpg,43,58,3,0,0,104
3152357796.jpg,1,14,76,17,0,108
3154777716.jpg,0,12,82,13,0,107
3154948821.jpg,0,26,111,11,0,148
3156288845.jpg,0,6,61,36,1,104
3157055534.jpg,4,46,50,7,0,107
3157096755.jpg,0,14,78,15,0,107
3157335389.jpg,6,53,50,2,0,111
3158018696.jpg,3,69,34,0,0,106
3158477442.jpg,0,23,61,12,0,96
3159188052.jpg,0,57,54,2,0,113
3161274755.jpg,0,4,46,48,2,100
3162134277.jpg,18,70,18,1,0,107
3164597811.jpg,0,1,52,51,0,104
3164921799.jpg,1,11,76,17,1,106
3165807292.jpg,0,3,46,55,3,107
316618516.jpg,6,82,39,1,0,128
3166870228.jpg,22,68,11,2,0,103
3168536494.jpg,0,23,70,13,0,106
3169607082.jpg,2,70,37,1,0,110
3170684406.jpg,0,2,42,60,2,106
3171148345.jpg,19,84,6,0,0,109
3172797742.jpg,0,9,66,35,2,112
3174536924.jpg,0,23,66,21,1,111
3175529254.jpg,0,14,66,22,1,103
3175555002.jpg,0,9,50,45,3,107
3176625404.jpg,0,20,60,19,0,99
3177560540.jpg,0,8,64,29,1,102
3177839887.jpg,0,0,24,74,5,103
3178336001.jpg,0,22,73,7,1,103
3178679066.jpg,0,0,24,81,6,111
3183550454.jpg,0,7,58,37,0,102
3183852879.jpg,0,13,71,20,0,104
3184407773.jpg,4,44,44,5,0,97
3184831791.jpg,0,1,42,57,2,102
318700026.jpg,0,1,38,66,6,111
3187135828.jpg,4,43,50,4,0,101
3187350017.jpg,0,3,59,41,0,103
3188292993.jpg,0,0,17,75,13,105
3188930402.jpg,0,1,58,41,0,100
3189407345.jpg,2,61,34,1,0,98
3190025525.jpg,1,20,71,9,0,101
3191275443.jpg,22,80,5,0,0,107
3193120688.jpg,0,9,69,30,0,108
3194036363.jpg,0,2,58,41,0,101
3194726912.jpg,0,8,71,27,0,106
3194756721.jpg,4,31,68,6,0,109
3195516092.jpg,0,1,42,61,1,105
319557469.jpg,0,9,70,27,0,106
3197293330.jpg,0,3,62,40,0,105
3199733593.jpg,0,7,61,34,1,103
3201560837.jpg,2,46,54,4,0,106
3201827278.jpg,0,9,57,39,0,105
3202755866.jpg,0,1,18,81,6,106
3204890107.jpg,13,69,18,0,0,100
3206140446.jpg,0,14,59,29,0,102
3206690420.jpg,0,17,63,23,0,103
3206894685.jpg,0,9,73,14,0,96
3207112247.jpg,0,14,63,27,1,105
3207463467.jpg,0,2,42,54,3,101
3207613793.jpg,4,65,38,0,0,107
3207927028.jpg,6,76,28,3,0,113
3207975884.jpg,1,62,46,0,0,109
3208711501.jpg,0,0,44,59,3,106
320987228.jpg,0,0,11,73,23,107
3210385990.jpg,0,1,48,60,1,110
3217227849.jpg,1,31,92,6,0,130
322036819.jpg,5,64,36,1,0,106
3220921320.jpg,1,8,62,34,1,106
322245825.jpg,0,7,73,22,0,102
3222932292.jpg,0,12,70,24,0,106
3224295308.jpg,0,10,64,32,0,106
3224700403.jpg,0,6,71,33,0,110
3225818665.jpg,51,53,3,0,0,107
3225993642.jpg,0,24,68,7,1,100
3226455393.jpg,0,0,25,67,9,101
3228786952.jpg,1,31,62,6,0,100
3228957282.jpg,0,1,61,63,0,125
3230042702.jpg,0,10,70,22,1,103
3230415578.jpg,2,35,60,6,0,103
3231616959.jpg,1,14,74,19,0,108
3233213622.jpg,0,2,57,46,3,108
3235296899.jpg,0,4,78,30,0,112
323541643.jpg,30,75,15,1,0,121
3238163707.jpg,0,9,101,27,0,137
3241749396.jpg,0,8,80,18,0,106
3241852622.jpg,1,17,66,15,4,103
3241859937.jpg,0,2,52,49,1,104
324220404.jpg,0,4,53,45,0,102
324339500.jpg,5,56,64,1,0,126
3243501762.jpg,3,55,45,2,0,105
3243513416.jpg,1,17,55,26,2,101
3244463289.jpg,0,11,78,17,0,106
3245550884.jpg,0,23,71,8,0,102
3247694646.jpg,1,14,54,35,1,105
3247974707.jpg,0,12,66,22,0,100
3248930020.jpg,0,9,69,21,1,100
3248976854.jpg,0,2,32,72,5,111
3250381402.jpg,13,59,28,2,0,102
3250534214.jpg,7,36,55,6,0,104
3251401307.jpg,1,17,69,14,0,101
325203196.jpg,46,54,5,0,0,105
3252078614.jpg,1,28,71,10,0,110
325223545.jpg,0,3,47,54,0,104
325296963.jpg,3,36,53,7,0,99
3253020934.jpg,0,3,36,66,0,105
3253636665.jpg,0,0,25,80,7,112
3254432034.jpg,2,7,53,45,2,109
3254444597.jpg,6,66,30,1,0,103
3255665645.jpg,0,1,22,80,4,107
3256723994.jpg,0,12,85,9,0,106
3256967457.jpg,0,26,66,11,0,103
3258713133.jpg,5,63,30,3,0,101
3258938541.jpg,0,0,39,62,1,102
3259283855.jpg,2,35,56,11,1,105
3259319485.jpg,0,3,55,67,3,128
3260332459.jpg,1,36,62,9,0,108
3260477963.jpg,1,29,64,14,1,109
3261123302.jpg,0,1,20,74,3,98
3261304564.jpg,0,7,40,56,2,105
3261536707.jpg,4,71,26,1,0,102
326195053.jpg,0,31,60,17,0,108
326299244.jpg,3,42,53,5,0,103
3265420201.jpg,0,4,51,55,3,113
3265568572.jpg,0,0,49,61,1,111
3272637437.jpg,0,4,40,57,5,106
3273769271.jpg,0,2,35,63,3,103
3274581285.jpg,1,5,47,47,4,104
3275523745.jpg,0,7,74,23,1,105
3277047132.jpg,0,3,45,54,4,106
3277064835.jpg,0,45,64,0,0,109
3277170769.jpg,0,6,75,20,1,102
3277186380.jpg,1,16,87,16,0,120
3281012528.jpg,0,4,62,43,0,109
3281066235.jpg,0,0,32,62,6,100
3282770938.jpg,0,2,55,51,0,108
3284203868.jpg,0,1,37,63,2,103
3285723816.jpg,4,66,39,2,0,111
3285865052.jpg,0,33,63,10,0,106
3288428899.jpg,8,64,29,4,0,105
3289145933.jpg,0,18,62,25,0,105
3290454927.jpg,0,43,60,4,0,107
3292481650.jpg,0,0,46,60,4,110
3293762912.jpg,0,10,70,26,0,106
3294786142.jpg,0,1,34,66,5,106
3295126634.jpg,5,47,49,0,0,101
3295438012.jpg,0,37,58,4,0,99
3296835726.jpg,0,1,61,48,0,110
3297887749.jpg,0,1,37,70,1,109
33000255.jpg,91,14,1,0,0,106
3301567767.jpg,1,32,67,12,0,112
3301587792.jpg,4,36,58,7,0,105
3302975736.jpg,0,12,69,27,1,109
3303080079.jpg,1,0,12,75,12,100
3303907744.jpg,0,0,22,68,11,101
3304434529.jpg,0,0,43,60,2,105
3304676774.jpg,0,4,64,36,0,104
3304800536.jpg,9,64,34,1,0,108
3305619554.jpg,0,1,31,65,5,102
3305968848.jpg,21,74,9,0,0,104
3306813341.jpg,0,1,41,64,2,108
3307215666.jpg,0,27,61,15,1,104
3308046325.jpg,4,25,70,11,1,111
3308341801.jpg,13,85,22,0,0,120
3308768118.jpg,0,2,30,67,7,106
3309384812.jpg,0,10,71,27,0,108
3309773235.jpg,1,32,64,4,0,101
3310204675.jpg,7,79,26,1,0,113
3310575214.jpg,7,60,35,0,0,102
3311728409.jpg,0,0,30,77,3,110
3312331811.jpg,31,66,4,0,0,101
331340631.jpg,5,24,55,23,3,110
331406867.jpg,34,67,6,0,0,107
3314110889.jpg,0,3,47,53,2,105
3314904869.jpg,9,59,29,1,0,98
3315237185.jpg,0,2,43,51,5,101
3315383233.jpg,27,63,10,0,0,100
3317434594.jpg,3,57,50,3,0,113
3320115265.jpg,0,2,31,68,1,102
332288233.jpg,3,22,63,9,1,98
3323033903.jpg,13,80,13,0,0,106
3323937813.jpg,0,9,66,30,0,105
3324248317.jpg,1,9,58,35,2,105
3324496492.jpg,1,34,72,5,0,112
3326988489.jpg,0,12,73,18,1,104
332883741.jpg,1,26,75,8,0,110
3329470769.jpg,0,19,71,21,0,111
3330470420.jpg,0,11,77,14,0,102
3331414151.jpg,0,9,70,30,2,111
333145920.jpg,0,2,57,52,0,111
3332423009.jpg,0,18,77,7,0,102
3332902834.jpg,0,10,53,48,1,112
3333985138.jpg,9,63,28,4,0,104
3335618194.jpg,0,0,32,73,0,105
3338894282.jpg,0,4,67,35,0,106
3340734956.jpg,0,5,62,37,1,105
3341085556.jpg,25,68,7,0,0,100
3342346685.jpg,0,40,57,8,0,105
3343738489.jpg,0,0,29,73,5,107
3344016385.jpg,0,10,66,25,0,101
3346416285.jpg,1,7,69,21,1,99
3347228837.jpg,0,5,40,46,4,95
3347823880.jpg,0,8,49,50,1,108
3350005307.jpg,55,51,4,1,0,111
3351610329.jpg,0,1,61,43,1,106
3351620207.jpg,0,12,49,45,0,106
3352596853.jpg,13,65,29,0,1,108
3355200103.jpg,0,1,51,82,4,138
3355209894.jpg,0,9,64,33,0,106
3355464174.jpg,0,4,67,34,0,105
3355714233.jpg,0,10,74,27,0,111
3356044640.jpg,0,5,65,40,0,110
3356844198.jpg,0,3,77,27,1,108
3357164852.jpg,0,21,70,12,0,103
3358149726.jpg,0,27,63,14,0,104
3358523670.jpg,0,3,56,65,1,125
3358682007.jpg,0,1,51,51,0,103
3358754066.jpg,3,48,52,3,0,106
3359889192.jpg,0,2,44,54,0,100
336052627.jpg,2,43,54,6,0,105
3361988100.jpg,0,3,48,57,0,108
3362731032.jpg,0,0,25,75,6,106
3364202369.jpg,0,0,32,73,1,106
3364722083.jpg,1,31,63,7,0,102
3364868711.jpg,16,73,13,1,0,103
3365417061.jpg,0,25,64,14,1,104
3365447434.jpg,25,95,13,0,0,133
3365471102.jpg,5,65,34,1,0,105
3366831652.jpg,0,7,55,46,2,110
3367044769.jpg,0,0,25,84,4,113
3367220434.jpg,0,1,40,59,2,102
3367803108.jpg,0,2,61,36,0,99
3368873733.jpg,0,9,62,35,1,107
3369391628.jpg,0,7,37,58,7,109
3370673214.jpg,0,4,59,41,0,104
3370823326.jpg,0,23,61,22,0,106
3371032149.jpg,0,13,50,41,0,104
3371856854.jpg,1,2,67,41,0,111
3372381586.jpg,4,61,41,0,0,106
3372418412.jpg,0,3,56,43,0,102
3376034906.jpg,6,69,34,0,0,109
3376076568.jpg,0,10,79,21,1,111
3376669178.jpg,0,19,73,11,0,103
3377992408.jpg,0,1,51,48,2,102
3378003631.jpg,0,3,62,32,0,97
3379476157.jpg,1,6,51,45,3,106
3381345467.jpg,2,39,60,6,0,107
3381533789.jpg,14,60,28,0,0,102
3383452055.jpg,0,6,69,34,2,111
3383593963.jpg,0,19,71,14,0,104
3383701765.jpg,0,2,60,43,1,106
3385195104.jpg,0,1,48,55,2,106
3385580051.jpg,4,48,47,6,1,106
3385696346.jpg,0,8,59,31,2,100
3385987418.jpg,0,3,50,52,3,108
3386943260.jpg,2,33,69,4,0,108
3386957170.jpg,0,3,42,63,2,110
3388691081.jpg,1,14,65,27,1,108
3388708914.jpg,0,1,44,51,6,102
3388712525.jpg,0,32,67,11,0,110
338924292.jpg,7,70,29,0,0,106
3390605400.jpg,14,70,16,0,0,100
3390896088.jpg,0,3,48,51,0,102
3391217731.jpg,3,64,29,4,0,100
3394722862.jpg,1,25,65,9,0,100
3395475764.jpg,0,9,90,34,0,133
3396059055.jpg,1,43,51,4,1,100
3398709851.jpg,0,53,49,5,0,107
3398940973.jpg,0,11,66,31,0,108
3398954278.jpg,0,2,56,46,1,105
3401900404.jpg,0,1,30,68,5,104
3403374656.jpg,0,10,67,26,1,104
3405525198.jpg,7,65,39,1,0,112
3411974393.jpg,1,27,68,15,0,111
3412359483.jpg,0,1,47,60,3,111
341491962.jpg,1,7,76,19,1,104
3416685588.jpg,20,65,21,1,0,107
3416752031.jpg,0,3,52,52,1,108
3417613077.jpg,2,29,61,14,0,106
3417674715.jpg,0,22,69,17,0,108
3418463077.jpg,0,2,21,75,8,106
3418667339.jpg,0,5,70,34,0,109
3420154563.jpg,1,20,74,16,0,111
3421464878.jpg,0,2,54,44,1,101
342221498.jpg,24,45,29,8,1,107
3423724895.jpg,0,3,27,63,14,107
3423896683.jpg,0,1,44,60,0,105
3423975366.jpg,0,2,50,54,1,107
3424993568.jpg,0,0,18,79,14,111
3426740196.jpg,22,67,16,2,0,107
3427902428.jpg,0,0,35,66,8,109
3427902514.jpg,0,1,43,55,1,100
3431105203.jpg,0,2,62,42,2,108
3431390099.jpg,4,50,45,1,0,100
3433315492.jpg,1,29,63,16,0,109
3434261812.jpg,0,30,68,7,0,105
3435545140.jpg,0,32,65,9,0,106
3437594883.jpg,10,59,38,0,0,107
3438059129.jpg,4,66,35,2,0,107
3439365851.jpg,0,0,33,75,2,110
3440235836.jpg,3,54,49,0,0,106
3442838312.jpg,0,17,77,15,1,110
3443268586.jpg,0,2,39,60,2,103
344443695.jpg,1,33,91,14,0,139
3444483519.jpg,0,2,56,47,3,108
3446054675.jpg,0,33,67,6,0,106
344636344.jpg,0,1,51,54,0,106
3446366493.jpg,1,3,47,54,1,106
3448332578.jpg,0,12,77,16,0,105
3449919327.jpg,0,2,55,44,6,107
3450351361.jpg,0,0,16,81,6,103
3450753884.jpg,0,1,50,50,4,105
3452963187.jpg,21,71,20,0,0,112
3455219027.jpg,4,71,27,0,0,102
3455882031.jpg,3,45,57,2,0,107
3456840631.jpg,0,0,39,97,2,138
3458045907.jpg,0,12,59,32,1,104
3458950384.jpg,0,2,48,102,4,156
3461062752.jpg,3,35,64,6,0,108
3462395913.jpg,0,29,72,5,0,106
3463146453.jpg,0,1,47,51,3,102
3463376543.jpg,1,18,55,24,1,99
3464327257.jpg,1,30,60,12,0,103
3464988666.jpg,45,54,3,0,0,102
3465087333.jpg,3,63,37,1,0,104
3465276119.jpg,0,2,56,45,5,108
346617303.jpg,4,71,30,0,0,105
346617779.jpg,19,75,5,0,0,99
3466610103.jpg,0,2,39,61,4,106
3467784087.jpg,0,0,54,52,0,106
3468424403.jpg,0,18,75,17,0,110
3469092597.jpg,0,4,49,54,0,107
3469199125.jpg,3,25,60,18,0,106
34713269.jpg,12,55,31,4,0,102
347162205.jpg,6,95,34,0,0,135
3471704982.jpg,0,5,48,55,1,109
3471964559.jpg,0,1,28,75,6,110
3472660238.jpg,0,1,39,63,2,105
3475569667.jpg,3,76,46,1,0,126
3475877294.jpg,7,90,14,0,0,111
34796696.jpg,0,11,41,47,5,104
3479727829.jpg,21,80,8,0,0,109
348162485.jpg,12,83,12,0,0,107
3482375790.jpg,0,3,64,34,0,101
3483143101.jpg,87,20,1,0,0,108
3483457230.jpg,0,16,76,14,0,106
3483459470.jpg,5,65,34,0,0,104
3483540691.jpg,2,23,69,6,0,100
3484057115.jpg,0,15,82,10,0,107
3485554199.jpg,1,19,73,7,0,100
3486204187.jpg,0,10,77,16,0,103
3487085790.jpg,0,2,42,59,1,104
3487701269.jpg,0,6,45,52,3,106
3489731995.jpg,0,4,51,57,1,113
3490117565.jpg,0,1,49,58,2,110
3490456545.jpg,9,44,52,3,0,108
3491336743.jpg,7,49,44,5,0,105
3491534419.jpg,0,7,59,36,0,102
3492624391.jpg,9,63,33,3,0,108
3494126077.jpg,0,0,26,81,3,110
3494272101.jpg,0,1,52,54,3,110
3494678423.jpg,0,32,62,11,0,105
3496521334.jpg,0,0,29,72,4,105
3497202348.jpg,0,12,68,22,2,104
349896134.jpg,2,73,54,0,0,129
3499629801.jpg,0,7,58,41,0,106
35002160.jpg,0,7,38,57,4,106
3501996576.jpg,0,0,46,58,0,104
3502153355.jpg,0,5,56,47,1,109
3503300231.jpg,0,0,17,83,8,108
3505262206.jpg,0,25,69,9,0,103
3505627590.jpg,2,56,44,4,0,106
3510063780.jpg,5,31,58,11,0,105
3511207085.jpg,0,1,43,66,0,110
3515651386.jpg,0,6,81,39,0,126
3515663938.jpg,0,0,40,64,1,105
3518265762.jpg,0,1,33,67,2,103
3518866605.jpg,0,9,91,25,1,126
3519364135.jpg,3,51,44,3,0,101
351997474.jpg,0,25,66,12,0,103
3522690935.jpg,0,36,72,3,0,111
352331466.jpg,4,65,53,6,0,128
3524216401.jpg,0,2,35,62,1,100
3524447745.jpg,0,12,58,37,0,107
3525647615.jpg,1,21,70,14,0,106
352602458.jpg,12,70,24,0,0,106
3526523265.jpg,0,5,74,29,0,108
352744670.jpg,48,51,7,0,0,106
3530486052.jpg,0,0,17,79,9,105
3530563948.jpg,0,16,81,10,0,107
35311267.jpg,12,79,15,1,0,107
3532282772.jpg,0,13,56,43,1,113
353228664.jpg,1,1,57,46,2,107
3532374814.jpg,0,3,46,54,0,103
3533949779.jpg,0,5,61,36,1,103
3534610078.jpg,0,0,28,74,2,104
3535978712.jpg,0,3,50,47,1,101
3536025260.jpg,3,80,20,1,0,104
3537044665.jpg,7,65,32,0,0,104
3537245055.jpg,0,15,86,32,0,133
3537658496.jpg,0,3,34,100,4,141
3538380259.jpg,1,25,81,4,0,111
3539454254.jpg,0,4,75,32,0,111
3541249074.jpg,0,1,48,55,2,106
354153075.jpg,1,52,51,3,0,107
3542002438.jpg,0,31,72,8,0,111
3545028223.jpg,0,9,71,26,1,107
3545446713.jpg,0,3,71,34,1,109
3545702131.jpg,1,27,61,8,0,97
3547062481.jpg,0,3,85,37,1,126
3547073718.jpg,0,0,21,83,5,109
3548223665.jpg,2,44,59,4,0,109
354899371.jpg,0,8,70,27,0,105
3549424661.jpg,5,49,46,9,0,109
3551648026.jpg,0,16,66,25,0,107
3552766173.jpg,0,0,30,66,5,101
3552877026.jpg,0,0,50,61,1,112
3555094283.jpg,0,18,62,27,3,110
3556213355.jpg,0,1,22,78,5,106
3558351395.jpg,31,60,11,0,0,102
3560022258.jpg,0,53,44,2,0,99
3560032600.jpg,0,5,51,46,0,102
3561351919.jpg,0,11,62,33,1,107
3561898679.jpg,0,3,44,59,0,106
3562407133.jpg,0,0,23,71,11,105
3563134047.jpg,0,5,44,54,2,105
356523006.jpg,0,3,67,36,3,109
3566079728.jpg,0,3,57,44,1,105
3566137302.jpg,0,8,62,33,0,103
3566227002.jpg,1,4,46,43,3,97
3566285762.jpg,0,4,54,41,1,100
3567613299.jpg,0,1,56,52,3,112
3567892894.jpg,0,1,56,45,0,102
3569097033.jpg,0,21,74,10,0,105
3569259520.jpg,0,7,76,27,0,110
3572950777.jpg,0,2,29,61,11,103
3574423584.jpg,0,7,71,31,0,109
357452255.jpg,12,75,17,0,0,104
3575258454.jpg,0,4,59,32,1,96
3576199867.jpg,1,0,34,60,5,100
357641600.jpg,26,81,2,0,0,109
3576734927.jpg,0,5,61,40,2,108
3576771116.jpg,0,18,73,12,0,103
3577464388.jpg,0,1,57,49,0,107
3577744786.jpg,15,74,13,1,0,103
3579701723.jpg,23,78,8,0,0,109
3581381105.jpg,0,0,29,77,2,108
358360301.jpg,0,2,59,45,1,107
358433606.jpg,18,66,24,0,0,108
358438532.jpg,5,63,35,1,0,104
3585032307.jpg,2,24,62,6,1,95
3585744087.jpg,16,68,20,3,0,107
3586744131.jpg,0,0,28,66,7,101
3586827526.jpg,0,0,43,58,1,102
3587076357.jpg,1,5,58,41,0,105
3587337138.jpg,1,33,53,11,0,98
3588199753.jpg,0,1,45,57,6,109
3589240869.jpg,2,7,32,54,5,100
3591617396.jpg,3,50,48,3,0,104
3592827455.jpg,0,8,57,36,0,101
3593791366.jpg,0,0,29,69,5,103
3595766183.jpg,0,0,40,65,1,106
3596611917.jpg,0,15,82,12,0,109
3596718064.jpg,0,1,47,81,0,129
3597095413.jpg,0,0,32,68,3,103
3597199001.jpg,0,1,40,67,1,109
359723983.jpg,0,2,37,58,8,105
3597613662.jpg,0,0,46,52,2,100
3599779537.jpg,0,6,56,44,0,106
3600948934.jpg,1,41,60,2,0,104
3601117533.jpg,0,2,60,47,1,110
3601352242.jpg,0,4,57,48,1,110
3603046487.jpg,0,27,72,10,0,109
3603762742.jpg,0,15,64,24,0,103
3604508101.jpg,0,1,75,31,0,107
3606644176.jpg,0,8,51,50,4,113
3606669688.jpg,0,12,42,41,3,98
3608137140.jpg,0,1,39,55,10,105
3608691305.jpg,0,7,76,23,0,106
3609473273.jpg,0,0,21,74,10,105
3609983548.jpg,0,6,64,36,0,106
361037189.jpg,0,0,8,108,10,126
3611703355.jpg,0,0,8,86,15,109
3612122165.jpg,0,8,61,34,0,103
3612174577.jpg,9,60,32,1,0,102
361252644.jpg,1,44,56,6,0,107
3613844312.jpg,0,0,15,80,9,104
3615125120.jpg,0,2,48,60,1,111
3615267731.jpg,0,1,45,58,0,104
3615562.jpg,15,82,8,1,0,106
3616806128.jpg,0,2,56,43,0,101
3618474326.jpg,0,7,40,55,1,103
3618795157.jpg,1,2,14,70,18,105
3619220193.jpg,1,13,65,25,1,105
3619609860.jpg,0,1,30,100,9,140
362016009.jpg,0,31,64,8,0,103
3620678223.jpg,0,10,66,27,0,103
3620726.jpg,19,79,9,0,0,107
362290262.jpg,1,2,29,66,2,100
3625351305.jpg,0,3,56,41,2,102
3628043.jpg,1,5,42,45,16,109
3628605791.jpg,0,31,62,20,0,113
3629779382.jpg,0,0,55,47,2,104
3630233855.jpg,2,17,51,34,1,105
3632417985.jpg,85,15,2,0,0,102
363482906.jpg,0,1,53,56,0,110
3635405613.jpg,0,21,75,12,0,108
3636701462.jpg,0,0,30,71,3,104
3637251050.jpg,3,24,68,12,1,108
3638870308.jpg,0,9,78,16,0,103
3639490630.jpg,1,38,63,7,0,109
3641084203.jpg,5,28,50,19,1,103
3642904232.jpg,0,2,32,66,4,104
36434642.jpg,1,25,57,20,1,104
3644585173.jpg,3,24,70,14,0,111
3645413545.jpg,3,70,31,0,0,104
3645793167.jpg,0,2,40,55,1,98
3647757599.jpg,0,9,82,15,0,106
364777572.jpg,0,4,71,33,1,109
3648316650.jpg,0,1,53,49,0,103
364905354.jpg,0,0,24,67,7,98
3649082846.jpg,1,14,76,13,1,105
3651951998.jpg,0,12,73,20,0,105
3652633823.jpg,0,0,61,73,0,134
3653350159.jpg,0,2,42,89,2,135
3653613515.jpg,0,6,53,43,0,102
3654348116.jpg,0,11,80,20,0,111
3655930326.jpg,0,29,70,6,0,105
3658535721.jpg,0,0,21,86,5,112
3658667754.jpg,0,2,42,60,1,105
3660430593.jpg,0,1,39,56,0,96
3660664464.jpg,0,4,55,46,4,109
3661422978.jpg,3,68,33,1,0,105
3662491369.jpg,2,27,61,19,0,109
3662558151.jpg,2,32,61,5,0,100
3662997757.jpg,0,3,33,79,0,115
3663320781.jpg,0,0,27,64,13,104
3663369776.jpg,0,1,29,78,5,113
3663960871.jpg,0,13,92,20,0,125
366471935.jpg,0,0,15,81,11,107
3665983083.jpg,0,0,23,77,3,103
3667890322.jpg,1,4,72,29,1,107
3669066809.jpg,7,53,43,7,1,111
3670445078.jpg,15,89,39,2,0,145
3670448728.jpg,7,61,37,0,0,105
3671193503.jpg,0,8,68,31,0,107
3673357278.jpg,0,1,51,51,2,105
3673502264.jpg,3,21,64,17,0,105
3674117315.jpg,0,3,76,27,0,106
3675002443.jpg,1,39,59,9,0,108
3676465885.jpg,1,11,55,34,2,103
3677460940.jpg,0,22,71,17,0,110
3678866923.jpg,0,1,47,63,1,112
3680743288.jpg,3,68,34,1,0,106
3683418770.jpg,0,14,66,25,1,106
3686287517.jpg,3,23,68,7,0,101
36869449.jpg,0,8,52,45,2,107
3688540831.jpg,0,3,37,58,7,105
3688594216.jpg,0,11,69,25,0,105
368909912.jpg,0,6,65,28,0,99
3689126503.jpg,0,1,24,68,8,101
3689872234.jpg,1,52,52,1,0,106
3691978983.jpg,0,1,31,61,10,103
3693087386.jpg,1,44,53,7,0,105
369451183.jpg,1,34,62,8,0,105
369605204.jpg,0,6,47,57,0,110
3697066196.jpg,0,3,66,28,0,97
3697493807.jpg,0,0,8,84,13,105
3697530291.jpg,0,1,12,76,13,102
3697878601.jpg,0,1,28,74,4,107
3698386210.jpg,0,23,72,14,0,109
3702144450.jpg,0,20,60,23,0,103
3702671816.jpg,0,2,58,44,3,107
3704662776.jpg,5,72,24,1,0,102
3705698114.jpg,0,20,73,9,0,102
3705884386.jpg,0,38,62,7,0,107
3706984010.jpg,17,65,21,3,0,106
3707022590.jpg,0,0,12,87,12,111
3707755654.jpg,2,32,67,8,0,109
3708130060.jpg,0,30,57,18,0,105
3708879448.jpg,2,13,41,41,4,101
3711573590.jpg,0,5,68,28,4,105
3711772310.jpg,4,54,45,4,0,107
3712529193.jpg,5,62,41,1,0,109
3713010621.jpg,4,44,52,6,0,106
3713773458.jpg,0,9,52,44,0,105
3714832332.jpg,1,37,63,8,0,109
3715014568.jpg,3,21,69,8,0,101
3715780832.jpg,0,10,64,33,1,108
3716186057.jpg,31,63,4,0,0,98
3716651057.jpg,0,0,22,87,4,113
3716891886.jpg,0,0,43,57,4,104
371935095.jpg,0,0,21,79,6,106
3719984050.jpg,0,8,56,41,0,105
372117089.jpg,0,0,57,50,0,107
3721179887.jpg,4,44,53,6,0,107
3722409963.jpg,9,67,35,2,0,113
3722476330.jpg,0,9,54,42,1,106
3722623767.jpg,0,27,67,12,0,106
3725954413.jpg,0,27,69,8,0,104
3726632967.jpg,0,5,55,41,1,102
3727572481.jpg,0,10,78,13,0,101
372866056.jpg,0,41,58,4,0,103
3729465678.jpg,7,63,32,4,0,106
3731180333.jpg,0,2,46,53,2,103
3733701155.jpg,0,1,25,76,5,107
3733759776.jpg,0,7,53,52,2,114
3734378087.jpg,0,37,60,13,0,110
3734577194.jpg,0,3,53,44,1,101
3734652007.jpg,1,20,66,19,0,106
3736336896.jpg,0,27,71,12,0,110
3736358849.jpg,6,78,24,1,0,109
3736418288.jpg,0,19,71,10,1,101
3736752039.jpg,0,1,34,65,2,102
3736907392.jpg,0,4,57,41,3,105
3737792738.jpg,7,66,30,1,0,104
3738819299.jpg,0,3,50,51,0,104
3739339628.jpg,2,20,60,25,2,109
3740923361.jpg,1,77,29,3,0,110
3741259519.jpg,0,5,59,39,3,106
3741472599.jpg,0,6,67,36,0,109
3742811862.jpg,0,14,75,16,1,106
3743649571.jpg,0,7,61,32,1,101
374612387.jpg,1,6,48,48,1,104
3749654443.jpg,5,60,38,2,0,105
3750200495.jpg,0,2,48,60,4,114
3750653207.jpg,2,41,57,9,1,110
375084308.jpg,0,8,64,27,2,101
3750920837.jpg,10,57,30,0,0,97
3753143338.jpg,65,39,4,0,0,108
375446021.jpg,0,27,75,5,0,107
3754491822.jpg,3,60,42,3,0,108
3754591467.jpg,10,46,37,6,0,99
3755058211.jpg,0,1,28,62,15,106
3755358004.jpg,0,4,41,53,7,105
3757841253.jpg,0,5,63,39,4,111
3758354055.jpg,0,1,52,50,1,104
3758613590.jpg,0,9,63,30,0,102
3758636614.jpg,2,55,44,1,0,102
3758843972.jpg,0,3,61,41,1,106
3759443485.jpg,0,45,52,1,0,98
3759763464.jpg,2,31,64,9,0,106
3761038439.jpg,0,12,106,12,0,130
3761173384.jpg,0,18,63,22,1,104
3761272199.jpg,0,8,64,33,0,105
3761519418.jpg,0,0,31,86,4,121
3764660296.jpg,0,2,20,110,3,135
3766742048.jpg,7,69,19,0,0,95
376684942.jpg,0,16,58,24,2,100
3767341492.jpg,5,56,37,3,0,101
3767933394.jpg,0,2,31,65,5,103
3768070080.jpg,34,62,13,0,0,109
3770559253.jpg,0,12,74,12,0,98
377273746.jpg,57,46,3,0,0,106
3773463532.jpg,0,0,15,81,10,106
3775591333.jpg,2,41,57,3,0,103
3775862144.jpg,0,1,46,61,2,110
3776716867.jpg,1,4,64,39,0,108
3779249317.jpg,0,0,43,65,4,112
3779311128.jpg,0,9,76,22,0,107
3780702032.jpg,0,0,36,62,3,101
3782183827.jpg,3,65,37,2,0,107
3783245891.jpg,0,19,66,19,0,104
3783312451.jpg,4,81,21,0,0,106
3783568353.jpg,0,19,52,37,1,109
3784715028.jpg,0,10,52,42,2,106
3785783338.jpg,0,9,58,37,2,106
3787014324.jpg,0,15,77,14,0,106
3787979013.jpg,0,1,20,73,16,110
3788379941.jpg,0,1,28,81,1,111
3788909806.jpg,0,10,51,40,1,102
3789837472.jpg,0,3,33,68,4,108
3791999774.jpg,20,72,7,1,0,100
3792338234.jpg,0,15,66,29,0,110
3792378354.jpg,0,2,70,35,0,107
379323686.jpg,0,3,39,54,5,101
379362291.jpg,0,9,77,20,1,107
3794248989.jpg,0,5,58,47,1,111
379437662.jpg,0,0,42,59,1,102
3794461596.jpg,0,3,48,50,3,104
37951657.jpg,43,59,2,0,0,104
3796455854.jpg,0,10,58,34,0,102
3797715149.jpg,0,4,50,47,3,104
3800059044.jpg,0,4,43,62,1,110
3800600451.jpg,0,0,17,82,11,110
3801275835.jpg,0,6,64,35,0,105
3804031946.jpg,0,0,38,62,2,102
3805107589.jpg,0,7,78,23,0,108
38056572.jpg,0,7,53,43,3,106
3806051518.jpg,44,50,6,0,0,100
3809644203.jpg,0,8,76,24,0,108
3810011859.jpg,6,54,46,1,0,107
381148704.jpg,0,17,67,20,0,104
3812031514.jpg,0,1,50,63,1,115
3812657000.jpg,0,5,117,29,0,151
3812865597.jpg,0,2,52,49,3,106
3812926720.jpg,0,1,38,58,4,101
3814668128.jpg,1,20,90,34,2,147
3815063597.jpg,1,29,67,6,0,103
3815098207.jpg,0,3,29,70,5,107
3816407980.jpg,0,2,60,45,0,107
3817723435.jpg,0,21,65,18,0,104
3817779484.jpg,2,27,64,11,0,104
3818998606.jpg,0,3,62,38,1,104
3820650799.jpg,6,56,41,1,0,104
3821275434.jpg,0,2,60,64,4,130
3822506826.jpg,2,59,46,2,0,109
3822808828.jpg,0,0,18,89,4,111
3824105113.jpg,0,17,77,21,0,115
3824362477.jpg,0,1,36,65,5,107
3824413541.jpg,0,3,35,76,2,116
3824485636.jpg,2,35,51,17,2,107
3825250471.jpg,0,0,25,77,6,108
3825304964.jpg,0,13,101,14,0,128
3825365753.jpg,0,5,49,48,5,107
3825837186.jpg,0,3,33,63,4,103
3826205454.jpg,0,5,69,45,0,119
3826585780.jpg,0,1,34,65,4,104
3827560087.jpg,0,0,32,75,3,110
382774042.jpg,35,56,12,0,0,103
3827911032.jpg,0,3,45,53,1,102
3827968988.jpg,0,26,87,13,0,126
3828155719.jpg,0,11,79,43,0,133
3828472247.jpg,0,13,78,19,0,110
3829660645.jpg,0,13,72,22,1,108
3835050024.jpg,0,25,60,19,0,104
3838001890.jpg,0,29,64,5,0,98
3839953318.jpg,0,12,76,22,0,110
3840546727.jpg,0,20,78,15,0,113
3840923045.jpg,0,25,63,18,0,106
3841233055.jpg,1,43,61,2,0,107
3841305755.jpg,0,6,74,32,0,112
3841509426.jpg,6,66,34,5,0,111
3843377036.jpg,0,10,78,20,0,108
3843859642.jpg,0,8,55,41,2,106
3844930238.jpg,0,2,94,58,0,154
3845656628.jpg,0,5,63,38,3,109
3846071699.jpg,0,4,73,50,0,127
3846844854.jpg,0,2,51,46,1,100
3847022878.jpg,0,0,60,39,2,101
384788069.jpg,0,3,17,72,8,100
3847915749.jpg,25,66,16,1,0,108
3847965007.jpg,2,42,50,7,0,101
3848727332.jpg,0,0,22,84,1,107
3848893941.jpg,0,8,40,62,0,110
3850107264.jpg,0,14,76,17,1,108
3850147128.jpg,0,6,37,57,3,103
3850577376.jpg,0,44,56,5,0,105
3851672801.jpg,0,0,31,73,4,108
3851941327.jpg,0,11,72,15,0,98
3853359984.jpg,0,7,57,31,2,97
3854279335.jpg,7,75,23,0,0,105
3855419676.jpg,0,1,19,72,8,100
3856196713.jpg,0,0,41,55,10,106
3856507445.jpg,0,7,79,23,0,109
3856900502.jpg,0,4,44,49,4,101
3860253466.jpg,0,5,80,29,0,114
3860848792.jpg,3,50,69,3,1,126
3861043546.jpg,0,1,42,60,1,104
3861673008.jpg,4,64,29,0,0,97
3864280906.jpg,0,1,37,69,2,109
3866688343.jpg,1,19,70,13,0,103
3867441709.jpg,0,2,46,45,6,99
386746008.jpg,2,6,60,45,0,113
3867705645.jpg,28,70,4,0,0,102
3867707916.jpg,0,13,69,22,0,104
387003357.jpg,8,74,24,1,0,107
3870343367.jpg,0,10,64,32,0,106
3870457394.jpg,0,2,67,39,2,110
3871801313.jpg,0,20,83,6,0,109
3872043875.jpg,0,3,62,31,2,98
3872509611.jpg,3,34,52,7,0,96
387259022.jpg,1,26,69,14,0,110
3872832716.jpg,0,25,58,19,0,102
3874298550.jpg,0,5,65,39,0,109
3874382715.jpg,6,63,28,2,0,99
3876341199.jpg,0,2,43,81,0,126
3876523676.jpg,0,3,37,66,2,108
3879362113.jpg,0,1,34,65,6,106
3880140639.jpg,1,73,28,3,0,105
3880718005.jpg,2,25,77,4,0,108
3881103730.jpg,0,0,13,83,12,108
3885568060.jpg,0,2,34,58,10,104
3886483510.jpg,0,1,41,58,0,100
3886718406.jpg,1,6,54,41,0,102
3886757277.jpg,0,35,57,11,0,103
3886880606.jpg,0,1,29,68,2,100
3888454309.jpg,17,78,11,1,0,107
3890421755.jpg,0,6,68,28,0,102
3890811565.jpg,0,4,62,41,0,107
3891717415.jpg,0,1,43,57,0,101
3892086124.jpg,0,15,83,40,1,139
3892332557.jpg,0,24,59,21,0,104
3894915205.jpg,0,1,60,79,1,141
3895433023.jpg,0,8,73,24,0,105
3895663827.jpg,0,35,57,9,0,101
3896434582.jpg,0,30,72,4,0,106
3898078585.jpg,35,70,7,0,0,112
3900873243.jpg,0,21,71,13,1,106
3900966844.jpg,3,69,37,4,0,113
390226070.jpg,0,5,31,63,5,104
3902626347.jpg,25,84,3,1,0,113
3903483278.jpg,6,40,56,6,0,108
3904942577.jpg,31,73,1,0,0,105
3905518312.jpg,2,47,53,1,0,103
3908700784.jpg,0,3,31,68,2,104
3908763168.jpg,0,1,34,69,5,109
3908866899.jpg,2,59,39,2,0,102
3910222592.jpg,0,3,37,68,2,110
3910973897.jpg,9,82,19,1,0,111
3913177014.jpg,2,20,70,12,0,104
3913188131.jpg,0,0,17,72,15,104
3916222248.jpg,0,1,24,67,5,97
3916243478.jpg,0,22,66,14,0,102
3916637949.jpg,4,33,56,12,2,107
3916850615.jpg,0,1,60,45,0,106
3916915691.jpg,0,23,77,8,0,108
3917849504.jpg,2,36,48,20,0,106
3918062562.jpg,0,1,26,67,9,103
3918280584.jpg,0,6,69,30,0,105
3918838221.jpg,12,61,34,3,0,110
3919380535.jpg,1,4,46,53,0,104
392103652.jpg,8,65,36,2,0,111
3921589638.jpg,0,1,39,61,3,104
392179845.jpg,53,86,5,0,0,144
3922421993.jpg,0,2,40,58,3,103
3923233289.jpg,4,89,13,0,0,106
3923541475.jpg,1,9,83,13,0,106
3925412649.jpg,0,4,57,41,1,103
392558137.jpg,2,49,47,6,0,104
3927444590.jpg,0,6,68,48,1,123
3927881802.jpg,0,7,55,39,0,101
3928559890.jpg,0,10,62,34,0,106
3930941584.jpg,5,48,49,0,0,102
3931210821.jpg,0,12,69,24,0,105
3932630945.jpg,0,4,58,41,0,103
3932684731.jpg,1,33,64,11,0,109
3932785686.jpg,5,49,47,9,0,110
3934165977.jpg,0,15,69,20,0,104
3934821151.jpg,0,5,37,56,3,101
3934995195.jpg,0,0,27,81,1,109
3935177366.jpg,29,66,7,1,0,103
3937913166.jpg,0,2,48,57,3,110
3938367619.jpg,1,25,63,14,1,104
3939043948.jpg,3,51,48,5,0,107
3939622523.jpg,0,24,48,31,0,103
3940105265.jpg,6,35,55,15,2,113
3940357186.jpg,0,38,63,2,0,103
3940847938.jpg,15,67,18,1,0,101
3941788092.jpg,0,2,52,46,0,100
3943080167.jpg,15,75,21,0,0,111
3944642127.jpg,0,1,47,56,7,111
3945869834.jpg,0,0,15,91,5,111
3946405001.jpg,0,0,36,68,1,105
3947046278.jpg,0,6,47,52,0,105
3948135332.jpg,0,3,46,66,0,115
3948277105.jpg,0,7,80,20,0,107
3948522988.jpg,2,31,56,15,0,104
3948731617.jpg,0,1,35,69,0,105
3949143151.jpg,0,0,63,58,0,121
3949472497.jpg,0,4,51,48,2,105
395036065.jpg,31,87,33,0,0,151
395147567.jpg,1,67,69,2,0,139
3951898034.jpg,0,1,37,68,4,110
3952840501.jpg,0,1,42,82,3,128
395315549.jpg,0,28,93,13,0,134
39540491.jpg,0,3,34,54,16,107
3954258141.jpg,0,7,57,38,2,104
3955560376.jpg,1,4,53,47,1,106
3956832242.jpg,1,41,60,3,0,105
3957754780.jpg,0,53,50,4,0,107
3960128594.jpg,0,15,75,12,0,102
3960444662.jpg,0,1,23,80,4,108
3960629357.jpg,0,17,81,38,2,138
3961390501.jpg,0,2,25,69,5,101
3961459513.jpg,0,0,36,66,1,103
3962058482.jpg,31,50,19,2,0,102
396221760.jpg,0,4,75,31,0,110
3962244093.jpg,0,2,48,48,1,99
3964553280.jpg,0,19,70,19,0,108
396505725.jpg,7,93,10,0,0,110
3965556653.jpg,0,18,65,23,1,107
3966627187.jpg,0,0,37,75,2,114
3966829877.jpg,0,3,46,53,3,105
3969622447.jpg,1,39,58,6,0,104
3970268650.jpg,0,0,34,65,1,100
3971050023.jpg,0,3,21,67,16,107
3971662930.jpg,0,27,70,9,0,106
3971799391.jpg,0,16,59,28,0,103
3973001148.jpg,3,56,44,3,0,106
3973813247.jpg,1,55,49,5,0,110
3974701478.jpg,1,17,63,29,1,111
3975469304.jpg,0,1,14,80,8,103
3976452832.jpg,0,11,83,16,0,110
3976883946.jpg,0,24,79,33,1,137
3977122123.jpg,1,8,93,25,0,127
3978652004.jpg,2,22,62,18,0,104
3978837773.jpg,0,10,72,40,0,122
3980206588.jpg,0,5,71,30,0,106
3980253534.jpg,1,18,74,14,0,107
3980401611.jpg,1,40,60,6,0,107
3982768803.jpg,0,15,69,18,0,102
3983499964.jpg,0,7,55,45,1,108
3984248064.jpg,18,74,17,0,0,109
3985027264.jpg,0,53,51,1,0,105
3985258920.jpg,2,18,57,29,0,106
398551269.jpg,1,37,56,13,0,107
3985602874.jpg,0,3,49,51,1,104
3986881860.jpg,0,1,22,84,1,108
3987605606.jpg,0,0,11,74,23,108
3989767571.jpg,0,15,100,10,0,125
3992677101.jpg,22,73,6,0,0,101
3993808694.jpg,8,46,41,12,0,107
3994007574.jpg,0,2,34,58,4,98
3994759280.jpg,0,5,58,43,1,107
3994759840.jpg,0,18,82,5,0,105
3995400927.jpg,0,7,64,31,1,103
3999106249.jpg,0,23,63,13,0,99
4000012271.jpg,0,0,16,79,15,110
4000500172.jpg,1,21,71,14,0,107
4000774743.jpg,0,8,71,27,1,107
4001539544.jpg,2,47,52,2,0,103
4002090879.jpg,0,3,64,73,4,144
4002265121.jpg,0,3,57,40,2,102
4003392015.jpg,4,55,42,2,0,103
4004417944.jpg,12,81,33,0,0,126
4005014529.jpg,0,21,63,21,0,105
4005164524.jpg,1,59,73,5,0,138
4005784260.jpg,0,0,47,58,3,108
4007753969.jpg,0,4,64,43,1,112
4008219206.jpg,1,11,72,22,2,108
4010417256.jpg,0,25,61,20,0,106
4010451143.jpg,0,2,37,68,1,108
4011871379.jpg,0,23,69,19,0,111
4014803633.jpg,20,76,11,0,0,107
4016051317.jpg,7,62,35,1,0,105
4016200124.jpg,0,3,51,44,1,99
4016398417.jpg,0,7,56,37,0,100
4016639569.jpg,0,4,41,47,6,98
4017312321.jpg,10,64,23,2,0,99
4018386659.jpg,0,10,73,22,0,105
4018505209.jpg,0,1,42,62,2,107
4018879156.jpg,7,50,44,3,0,104
4019770428.jpg,0,1,47,58,4,110
4023100592.jpg,22,71,23,1,0,117
4023245742.jpg,0,18,71,15,0,104
4023598688.jpg,0,17,65,17,0,99
4026925102.jpg,0,6,56,42,3,107
4027767419.jpg,0,8,74,18,0,100
4028266820.jpg,0,5,56,50,1,112
4029731030.jpg,2,22,66,12,0,102
4033495510.jpg,10,70,27,0,0,107
4034220859.jpg,0,29,76,8,0,113
4034290606.jpg,0,8,65,29,1,103
4034550282.jpg,3,70,36,3,0,112
4035961068.jpg,1,50,45,4,0,100
4036944943.jpg,0,2,25,97,2,126
4037056912.jpg,0,44,52,5,0,101
4037555676.jpg,21,73,15,0,0,109
4039710407.jpg,0,1,45,52,10,108
403993453.jpg,5,77,20,1,1,104
404033442.jpg,0,4,65,37,0,106
4040650709.jpg,1,39,58,7,0,105
4040905906.jpg,0,0,48,60,1,109
4041954882.jpg,0,0,28,81,4,113
4042188530.jpg,8,37,54,3,0,102
4042245241.jpg,6,49,50,8,0,113
4042292027.jpg,0,12,71,30,0,113
4042306910.jpg,0,24,69,8,0,101
4042433513.jpg,1,29,59,14,0,103
4042572733.jpg,5,38,60,2,0,105
4042987026.jpg,16,73,17,1,0,107
4045599734.jpg,0,1,35,70,0,106
4046637583.jpg,4,80,40,1,0,125
4046716515.jpg,2,59,67,1,0,129
4047293612.jpg,0,1,60,45,1,107
4047658369.jpg,0,6,54,35,1,96
4049047636.jpg,35,72,4,1,0,112
4050875089.jpg,0,1,39,59,2,101
4054072823.jpg,0,17,60,24,1,102
4054594935.jpg,0,1,34,69,0,104
4054655583.jpg,0,24,72,8,0,104
4054847919.jpg,0,0,34,61,6,101
4056860839.jpg,0,0,25,76,6,107
405908679.jpg,0,9,86,44,4,143
4062759482.jpg,5,77,30,0,0,112
4063780436.jpg,0,5,76,24,0,105
4065100469.jpg,0,3,54,43,1,101
4067961238.jpg,1,75,67,1,0,144
4068780416.jpg,1,36,62,4,0,103
406881914.jpg,0,0,13,87,9,109
4069729710.jpg,0,0,39,63,1,103
4074943155.jpg,2,9,70,30,0,111
4075989770.jpg,0,31,60,11,0,102
4076940518.jpg,0,1,54,44,4,103
4077667734.jpg,0,2,34,60,11,107
4078925567.jpg,2,54,93,1,0,150
4079545582.jpg,0,7,68,30,0,105
4079839829.jpg,0,37,58,2,0,97
4080245276.jpg,33,65,4,0,0,102
4080731983.jpg,0,3,58,45,1,107
4081025902.jpg,2,42,60,4,0,108
4081293153.jpg,0,5,70,30,0,105
4083824869.jpg,0,16,77,13,0,106
4084687519.jpg,0,1,50,58,1,110
4085075628.jpg,1,23,95,16,0,135
408607884.jpg,0,17,60,32,1,110
4086204414.jpg,15,66,20,0,0,101
4087443308.jpg,0,1,46,56,1,104
4088500384.jpg,1,11,76,21,1,110
4089514101.jpg,0,1,31,76,3,111
4091583861.jpg,3,44,57,3,0,107
409233389.jpg,3,34,65,9,0,111
4092627138.jpg,0,6,60,43,1,110
409280416.jpg,0,25,77,6,0,108
409446076.jpg,2,54,43,3,0,102
4094774604.jpg,3,48,43,4,0,98
4094850958.jpg,11,71,20,0,0,102
4095160762.jpg,0,0,67,37,5,109
4095383312.jpg,4,49,45,7,0,105
4095785910.jpg,0,27,88,16,0,131
409597917.jpg,2,67,60,1,0,130
409821164.jpg,0,2,71,31,1,105
4098700616.jpg,0,4,59,47,0,110
4099198318.jpg,1,20,67,13,0,101
4100096331.jpg,40,57,11,0,0,108
4100631766.jpg,0,44,52,6,0,102
4103115026.jpg,55,53,2,0,0,110
4103158795.jpg,0,2,37,63,3,105
4106514523.jpg,0,2,31,74,0,107
4106517753.jpg,0,2,31,76,1,110
4107362083.jpg,0,1,17,69,17,104
4107566763.jpg,1,18,51,33,0,103
4109408743.jpg,0,0,30,76,1,107
411025625.jpg,0,2,62,78,2,144
4110400471.jpg,0,9,67,29,0,105
411090819.jpg,44,46,10,1,0,101
4112798557.jpg,0,1,12,76,12,101
41130035.jpg,0,1,27,65,11,104
4113272660.jpg,1,15,53,34,2,105
4113685341.jpg,80,26,1,0,0,107
4114019902.jpg,0,6,54,55,2,117
4114743309.jpg,0,0,29,71,2,102
411787882.jpg,0,0,31,66,7,104
4122173034.jpg,0,12,81,14,1,108
412289790.jpg,36,66,5,0,0,107
4124391067.jpg,24,80,7,0,0,111
4124667437.jpg,3,41,58,6,0,108
4125943270.jpg,1,1,30,69,8,109
4126410943.jpg,2,51,50,1,0,104
4127387822.jpg,0,0,32,67,6,105
4127400247.jpg,2,37,96,3,0,138
4128658349.jpg,0,1,45,50,3,99
4130373740.jpg,0,12,79,15,1,107
4131278870.jpg,0,0,20,75,6,101
4132558989.jpg,0,1,30,65,8,104
4132747677.jpg,0,3,61,36,0,100
4135617147.jpg,0,2,62,52,0,116
4136576616.jpg,0,1,40,69,0,110
4137012282.jpg,3,30,62,9,1,105
4138608778.jpg,0,4,56,46,0,106
4139461254.jpg,0,2,66,31,1,100
4139991387.jpg,0,8,76,20,0,104
4141916319.jpg,0,0,41,60,5,106
4142709624.jpg,0,3,26,71,6,106
4142940823.jpg,0,2,56,51,0,109
4143454418.jpg,0,19,94,22,0,135
4143494301.jpg,0,16,69,23,0,108
414385138.jpg,0,5,38,54,1,98
4144540155.jpg,0,8,59,43,0,110
4146534497.jpg,4,40,77,4,0,125
4147791219.jpg,0,5,74,23,0,102
414892775.jpg,0,5,69,36,0,110
4149241552.jpg,0,9,45,54,1,109
4149265699.jpg,0,3,54,38,1,96
4149460224.jpg,8,70,30,1,0,109
4151017008.jpg,0,8,53,40,4,105
4151551954.jpg,0,4,69,22,0,95
415283727.jpg,1,24,60,17,1,103
4154530402.jpg,1,19,61,19,0,100
4155484757.jpg,0,1,62,37,2,102
4156345687.jpg,0,1,52,81,6,140
4156534842.jpg,0,4,76,21,0,101
415663858.jpg,0,43,58,8,0,109
4156652933.jpg,0,6,61,38,4,109
4157144630.jpg,0,27,77,8,0,112
4157443022.jpg,0,1,29,77,6,113
4157689684.jpg,3,35,59,12,0,109
4158327759.jpg,1,22,62,22,0,107
4162089194.jpg,0,22,63,18,0,103
4162338388.jpg,1,7,50,48,0,106
4163479239.jpg,1,47,55,2,0,105
4164273130.jpg,0,1,32,67,4,104
416573735.jpg,6,51,49,4,0,110
4167140049.jpg,0,6,63,30,1,100
4167190092.jpg,0,66,41,0,0,107
4167198294.jpg,1,52,48,1,0,102
4167927417.jpg,1,38,59,12,0,110
416910261.jpg,9,65,26,0,0,100
4169148705.jpg,0,8,51,37,3,99
4169643886.jpg,1,38,80,13,0,132
4170535749.jpg,2,20,62,19,0,103
4171644754.jpg,0,2,65,39,1,107
4172438232.jpg,0,1,52,51,0,104
4172609703.jpg,1,61,48,0,0,110
4172859607.jpg,0,14,69,23,0,106
4172951303.jpg,0,13,72,20,0,105
4174114328.jpg,0,1,47,52,0,100
4174901273.jpg,0,27,67,8,0,102
4175024777.jpg,2,53,40,4,0,99
4176378029.jpg,1,36,50,13,0,100
417711208.jpg,0,2,47,52,4,105
4178406108.jpg,2,81,24,0,0,107
4178432884.jpg,0,33,61,6,3,103
417853178.jpg,0,1,37,66,1,105
4178645830.jpg,0,2,48,60,2,112
4180311266.jpg,0,5,30,60,9,104
418145002.jpg,0,10,64,29,0,103
4182412787.jpg,27,67,12,0,0,106
4182428810.jpg,4,51,67,6,0,128
418308346.jpg,0,7,67,27,0,101
4183330908.jpg,0,1,54,50,1,106
4184866542.jpg,1,10,62,37,0,110
4185039279.jpg,0,0,34,71,2,107
4186216137.jpg,0,3,59,34,0,96
4186428624.jpg,0,0,65,38,2,105
4187118157.jpg,0,0,26,69,8,103
4187182991.jpg,1,30,73,9,0,113
4190943330.jpg,0,45,58,5,0,108
4191882783.jpg,0,31,69,4,0,104
4193122125.jpg,0,4,67,33,0,104
4193696727.jpg,1,14,76,17,0,108
4193794378.jpg,57,47,0,0,0,104
4194035905.jpg,0,5,41,59,4,109
4194428227.jpg,0,2,26,71,5,104
4195621541.jpg,0,14,73,21,0,108
4195632386.jpg,10,80,20,0,0,110
4196095816.jpg,2,12,56,36,3,109
4196316000.jpg,5,74,29,0,0,108
4198235482.jpg,2,51,44,3,0,100
4199130600.jpg,0,4,28,65,5,102
4201007649.jpg,0,3,69,33,0,105
4201088382.jpg,0,9,66,34,1,110
4202847613.jpg,1,40,53,6,0,100
4204561283.jpg,10,76,23,1,0,110
4206004485.jpg,45,51,12,1,0,109
4206098907.jpg,1,35,55,5,0,96
4207059536.jpg,0,19,73,14,1,107
4210559322.jpg,17,55,32,5,0,109
4210983675.jpg,0,10,66,35,0,111
4211408239.jpg,3,20,62,19,0,104
4213244648.jpg,0,6,44,52,3,105
4213334951.jpg,8,69,26,1,0,104
4213592284.jpg,0,22,72,11,0,105
4214550696.jpg,2,10,70,28,1,111
4214561622.jpg,1,40,59,6,0,106
4214814193.jpg,0,0,43,58,3,104
4215055375.jpg,2,65,35,2,0,104
4215952664.jpg,0,0,22,67,12,101
4216117221.jpg,11,68,20,2,0,101
4217228822.jpg,1,47,54,8,1,111
4217243298.jpg,1,16,57,25,2,101
4217551619.jpg,0,8,48,40,7,103
4220863406.jpg,0,10,64,29,0,103
422092606.jpg,0,2,70,28,2,102
4222055381.jpg,0,6,73,21,0,100
4223697086.jpg,0,6,54,45,0,105
4224633098.jpg,0,0,13,82,13,108
4228738752.jpg,0,2,41,61,1,105
4229929371.jpg,1,0,29,69,6,105
4231049527.jpg,0,14,70,18,0,102
4232014784.jpg,71,35,1,0,0,107
4232963375.jpg,35,57,13,1,0,106
4233571199.jpg,0,1,20,78,8,107
4234199993.jpg,0,5,56,42,0,103
4236326911.jpg,0,19,67,16,0,102
4236329723.jpg,20,82,11,0,0,113
4236732050.jpg,0,1,59,44,0,104
4237536969.jpg,0,1,48,88,1,138
4239274380.jpg,20,88,28,1,0,137
4239526963.jpg,0,2,36,67,1,106
4240173491.jpg,0,1,35,71,5,112
4240917469.jpg,1,22,63,15,0,101
4241084648.jpg,54,52,1,0,0,107
4242548000.jpg,1,5,54,37,0,97
4243451745.jpg,0,0,34,72,2,108
4243562466.jpg,0,2,56,43,5,106
4243875190.jpg,0,1,38,59,3,101
4244098975.jpg,0,13,66,22,0,101
4244935320.jpg,0,7,51,47,2,107
4245591001.jpg,0,5,53,51,1,110
4246091470.jpg,4,34,55,10,0,103
4246274521.jpg,0,8,61,41,2,112
4246970583.jpg,9,76,21,1,0,107
4247073360.jpg,64,41,4,0,0,109
4248616737.jpg,6,33,43,23,0,105
42490373.jpg,0,14,46,40,3,103
4250403356.jpg,3,76,26,1,0,106
4251971063.jpg,0,1,28,66,2,97
4252517673.jpg,0,4,64,36,1,105
4252888669.jpg,0,2,30,66,2,100
4253075090.jpg,0,0,31,75,4,110
4254945684.jpg,29,68,10,0,0,107
4255841453.jpg,0,4,62,37,2,105
4255843674.jpg,0,3,65,34,2,104
4256128407.jpg,7,73,27,0,0,107
4257293580.jpg,19,73,21,0,0,113
4258180825.jpg,0,5,66,39,1,111
4258446622.jpg,0,10,91,24,0,125
4258644297.jpg,1,0,48,55,4,108
4259043215.jpg,0,2,62,45,0,109
4259140344.jpg,1,8,76,14,0,99
425916994.jpg,2,62,42,4,0,110
4259335567.jpg,1,50,48,2,0,101
4260146768.jpg,0,2,47,52,1,102
426081951.jpg,0,0,32,73,1,106
4261186099.jpg,1,32,63,5,0,101
42614998.jpg,1,22,56,25,3,107
4262472308.jpg,0,0,33,70,0,103
4263025475.jpg,0,3,28,65,8,104
4264601430.jpg,0,2,30,69,8,109
4265829347.jpg,0,1,31,68,1,101
4265877256.jpg,0,37,105,5,0,147
426656293.jpg,0,22,79,3,0,104
4268587808.jpg,1,5,56,42,2,106
4270305165.jpg,4,47,91,8,0,150
4270574025.jpg,7,43,48,3,0,101
427196028.jpg,2,52,43,2,0,99
4273357838.jpg,0,3,59,47,0,109
4275452644.jpg,0,4,52,53,0,109
4277299546.jpg,1,40,62,4,0,107
4277539505.jpg,0,4,58,43,0,105
4278181256.jpg,0,39,59,5,1,104
4278539127.jpg,0,14,59,30,3,106
4281546585.jpg,0,7,62,41,1,111
4281583432.jpg,0,5,73,30,1,109
4281731487.jpg,0,1,22,65,11,99
4281871655.jpg,8,76,18,0,0,102
4282135501.jpg,1,15,62,30,0,108
4285776519.jpg,9,70,24,0,0,103
4286933249.jpg,0,1,33,72,2,108
4286953087.jpg,9,57,42,3,0,111
4287953710.jpg,2,23,74,8,0,107
4288180189.jpg,0,27,62,15,0,104
4289036535.jpg,7,58,35,1,0,101
4290975910.jpg,2,36,54,11,0,103
4292573500.jpg,0,1,55,54,1,111
4293785816.jpg,6,36,53,10,0,105
4294746447.jpg,5,72,32,0,0,109
4295279371.jpg,0,18,74,10,0,102
4295525241.jpg,3,59,65,3,0,130
4296403133.jpg,15,67,22,1,0,105
4296647005.jpg,0,1,44,60,2,107
4297219009.jpg,2,56,48,2,0,108
4297599043.jpg,0,6,102,46,1,155
4297818651.jpg,3,62,67,2,0,134
4298067776.jpg,0,1,47,52,3,103
4298186333.jpg,0,2,50,57,2,111
4298923773.jpg,0,22,69,12,0,103
4299216840.jpg,83,21,1,2,0,107
4299510764.jpg,0,0,53,49,2,104
4299890430.jpg,0,8,66,33,0,107
4300118450.jpg,0,2,46,55,1,104
4300400521.jpg,1,32,64,4,0,101
430051470.jpg,0,10,96,35,0,141
4302524395.jpg,2,62,74,2,0,140
4304984630.jpg,0,5,57,41,2,105
4305975001.jpg,0,1,27,69,5,102
4306124216.jpg,25,66,15,0,0,106
4307315285.jpg,0,5,51,41,0,97
4309440479.jpg,0,16,105,33,0,154
430961914.jpg,0,1,45,56,2,104
4310499723.jpg,1,19,73,13,0,106
4311062470.jpg,0,2,70,36,2,110
4312794040.jpg,0,7,62,37,2,108
4313162470.jpg,0,1,57,51,0,109
4313852687.jpg,0,0,40,64,3,107
4315078660.jpg,0,52,49,6,0,107
4316201498.jpg,0,6,47,49,4,106
4316264959.jpg,0,6,57,47,0,110
4319709983.jpg,0,6,57,40,0,103
4319921272.jpg,4,42,55,3,0,104
4320399633.jpg,0,8,73,27,0,108
4321538602.jpg,0,1,54,46,0,101
432158024.jpg,0,1,25,72,4,102
4321643395.jpg,0,12,68,32,0,112
4321708869.jpg,0,24,69,8,0,101
432256405.jpg,1,24,64,19,0,108
4323308644.jpg,0,3,56,46,1,106
4323755897.jpg,0,7,65,36,0,108
4324984866.jpg,0,6,63,35,0,104
4324997197.jpg,0,53,48,5,0,106
4325351330.jpg,1,18,71,9,0,99
432860543.jpg,0,1,8,87,6,102
4330138497.jpg,0,1,29,69,7,106
4331601397.jpg,0,2,62,42,1,107
4333231936.jpg,4,68,30,1,0,103
4333476367.jpg,32,47,22,8,0,109
4335495125.jpg,13,78,13,0,0,104
4335627943.jpg,0,6,75,22,0,103
4335962068.jpg,0,21,51,33,0,105
4336185725.jpg,0,2,51,52,0,105
4336460350.jpg,0,0,33,68,0,101
4336745838.jpg,0,10,67,27,1,105
4336949009.jpg,0,2,43,63,0,108
433731087.jpg,14,78,10,1,0,103
4337515200.jpg,0,3,62,35,4,104
4338156096.jpg,0,4,63,40,2,109
4340329166.jpg,0,0,36,67,3,106
434108213.jpg,2,59,41,5,0,107
434127863.jpg,1,11,60,31,2,105
4343097092.jpg,0,3,55,48,1,107
4343304474.jpg,1,38,57,10,0,106
4344642946.jpg,0,0,32,71,2,105
4345036113.jpg,0,1,25,73,4,103
4345778112.jpg,0,0,34,65,2,101
4345842908.jpg,0,9,78,20,0,107
434605634.jpg,0,0,39,61,5,105
4346944645.jpg,0,3,45,54,2,104
4346999174.jpg,0,2,29,68,3,102
4347028779.jpg,0,4,68,28,0,100
4347235307.jpg,0,2,14,89,7,112
4347675881.jpg,1,31,60,21,0,113
434815119.jpg,19,77,9,0,0,105
435179511.jpg,0,0,13,73,13,99
4352372142.jpg,2,1,37,65,1,106
4353430545.jpg,23,103,26,0,0,152
4353485101.jpg,9,63,33,2,0,107
4353658003.jpg,56,47,6,1,0,110
4356238035.jpg,0,26,69,11,0,106
4356674628.jpg,0,3,77,29,0,109
4357293162.jpg,0,2,43,65,1,111
435823507.jpg,0,1,46,57,0,104
4358436337.jpg,0,5,48,53,2,108
4359434065.jpg,0,1,31,71,4,107
4359682859.jpg,0,0,15,84,6,105
4359967769.jpg,0,36,69,5,0,110
4360105019.jpg,11,115,24,0,0,150
4360193081.jpg,0,2,38,62,0,102
4360974596.jpg,0,29,76,4,0,109
4363262095.jpg,0,8,80,19,0,107
4364606780.jpg,0,3,21,72,15,111
4364793888.jpg,0,0,44,60,5,109
4365387751.jpg,0,4,42,59,0,105
4367292033.jpg,0,7,70,29,0,106
4367864472.jpg,0,17,79,24,2,122
4370903350.jpg,1,14,56,37,0,108
4370988573.jpg,4,59,34,9,0,106
4371356797.jpg,0,27,72,11,1,111
4372249937.jpg,3,69,33,1,0,106
4373157351.jpg,1,9,72,26,0,108
4373225530.jpg,0,5,63,61,0,129
4374031327.jpg,0,3,66,34,0,103
4374263037.jpg,0,8,51,42,0,101
43749901.jpg,3,61,38,4,0,106
4376625237.jpg,1,45,54,3,0,103
4376675146.jpg,8,49,43,4,0,104
4378419360.jpg,0,5,53,41,1,100
4383247323.jpg,5,23,57,17,0,102
4384734404.jpg,7,57,35,2,0,101
4385399670.jpg,2,22,73,16,0,113
4388983100.jpg,5,65,34,1,0,105
4389152317.jpg,0,0,34,71,1,106
4389836139.jpg,4,49,44,5,0,102
4389975585.jpg,0,4,66,34,1,105
4390875397.jpg,0,16,74,14,0,104
4391005979.jpg,0,26,80,2,0,108
4391517237.jpg,0,11,70,21,0,102
4393459228.jpg,0,1,34,69,2,106
4394545032.jpg,3,16,74,14,0,107
4395388551.jpg,0,4,62,39,2,107
4396087406.jpg,0,7,72,29,0,108
4396643142.jpg,0,1,29,67,6,103
4397008731.jpg,1,18,66,25,1,111
4397075898.jpg,0,2,33,70,0,105
439745674.jpg,3,47,51,7,0,108
4397886158.jpg,0,7,69,32,0,108
4398385361.jpg,0,0,14,77,14,105
44009500.jpg,88,21,0,0,0,109
4401185827.jpg,5,33,59,10,0,107
440297710.jpg,0,13,64,24,1,102
4404389524.jpg,1,46,54,5,0,106
4404462627.jpg,0,18,74,14,0,106
4405802084.jpg,1,34,73,3,0,111
4406684120.jpg,0,6,81,19,0,106
4406927427.jpg,2,13,70,15,1,101
4407707944.jpg,0,2,25,73,3,103
4407839974.jpg,0,6,60,39,0,105
4408351965.jpg,0,6,64,30,2,102
4409503429.jpg,8,80,16,1,0,105
4410900135.jpg,8,81,10,1,0,100
4410907563.jpg,0,52,48,6,1,107
4411055719.jpg,18,74,13,0,0,105
4411284601.jpg,0,6,57,40,0,103
4411449023.jpg,0,4,51,42,0,97
441241455.jpg,1,46,76,3,0,126
4413028246.jpg,0,1,45,60,4,110
4414969933.jpg,0,3,57,37,0,97
4416477559.jpg,0,1,32,69,3,105
4418637804.jpg,1,5,41,59,1,107
4420506536.jpg,0,1,49,54,3,107
4420983663.jpg,6,76,22,1,0,105
4422544352.jpg,0,5,55,43,2,105
4422726404.jpg,0,2,47,51,3,103
4423100872.jpg,40,63,4,0,0,107
4423467099.jpg,0,19,64,22,0,105
4423499380.jpg,0,7,66,35,1,109
4423525827.jpg,2,28,69,6,0,105
4424481742.jpg,0,1,41,69,1,112
4424741537.jpg,0,9,66,34,1,110
4425198356.jpg,0,2,62,40,0,104
4426149096.jpg,0,5,79,54,1,139
4428546636.jpg,0,23,91,11,0,125
4429141481.jpg,0,1,39,71,2,113
4429610219.jpg,0,2,21,86,4,113
4429773001.jpg,0,2,49,60,1,112
4430203972.jpg,0,2,46,50,2,100
4430414110.jpg,0,1,12,81,14,108
4430662019.jpg,1,33,60,14,0,108
4432333136.jpg,16,79,8,0,0,103
4432502474.jpg,0,5,64,32,0,101
4433497740.jpg,0,8,60,34,0,102
4434357623.jpg,1,1,35,67,7,111
4435718106.jpg,3,16,70,18,0,107
4435765484.jpg,0,9,74,18,0,101
4436002363.jpg,3,22,60,14,0,99
4436568659.jpg,0,3,60,47,1,111
443706084.jpg,0,3,67,32,0,102
443805629.jpg,0,6,67,25,0,98
4438338527.jpg,0,17,57,27,2,103
4439151807.jpg,0,0,18,83,10,111
4441487494.jpg,0,1,54,52,0,107
4441540278.jpg,0,6,64,35,5,110
4441586110.jpg,0,6,41,53,2,102
4441689311.jpg,0,7,67,39,0,113
4441990593.jpg,0,0,37,59,4,100
4442175074.jpg,0,0,8,83,14,105
4443705808.jpg,5,65,26,6,0,102
4446289911.jpg,4,68,32,1,0,105
4447897373.jpg,1,23,72,14,0,110
4448002516.jpg,0,1,47,53,4,105
4448707293.jpg,0,1,22,73,10,106
4456140613.jpg,0,0,13,95,3,111
4456369143.jpg,0,10,60,39,1,110
4458082894.jpg,0,22,71,15,0,108
445846327.jpg,0,0,16,82,9,107
4458877862.jpg,1,38,56,10,0,105
4459598484.jpg,0,3,61,46,1,111
4460254023.jpg,0,3,37,61,0,101
4462477090.jpg,2,37,59,5,0,103
4463196857.jpg,8,58,33,2,0,101
4463467980.jpg,0,0,19,63,26,108
4463917829.jpg,0,26,75,9,0,110
4464186761.jpg,0,0,20,75,6,101
4466660724.jpg,0,1,55,43,1,100
446796521.jpg,4,67,34,1,0,106
4468108530.jpg,0,13,57,34,0,104
4468449550.jpg,2,13,62,29,0,106
4469938423.jpg,3,12,71,22,0,108
4471526544.jpg,0,8,66,35,0,109
4472735511.jpg,0,21,69,14,0,104
4473061240.jpg,0,13,52,38,2,105
4475438101.jpg,0,1,59,47,2,109
4476029726.jpg,0,8,43,46,5,102
4476603465.jpg,0,5,52,49,6,112
447697089.jpg,0,4,54,46,3,107
4478081768.jpg,2,36,83,4,0,125
4478237731.jpg,1,9,70,30,3,113
447977798.jpg,0,15,68,18,0,101
4480082097.jpg,0,0,25,81,4,110
4483042022.jpg,0,2,64,41,0,107
448305008.jpg,0,5,58,48,2,113
4483151821.jpg,5,62,33,4,0,104
4484527101.jpg,0,1,60,37,2,100
4486733557.jpg,0,8,69,24,0,101
4488104431.jpg,0,48,55,4,0,107
4488491323.jpg,1,56,39,2,0,98
4489064763.jpg,1,10,55,32,4,102
4489102480.jpg,1,11,74,25,0,111
4490789851.jpg,0,2,25,74,4,105
4491574274.jpg,0,1,36,69,2,108
4492079346.jpg,0,13,61,28,2,104
4492298311.jpg,0,5,35,67,2,109
4493244545.jpg,0,1,28,75,4,108
449395753.jpg,1,13,66,18,0,98
4495516735.jpg,0,5,60,43,1,109
4495630749.jpg,0,1,22,83,4,110
4495910719.jpg,2,36,54,11,0,103
4496338663.jpg,3,41,53,3,0,100
4497186913.jpg,1,19,82,7,0,109
4497739993.jpg,0,11,60,37,1,109
4499122119.jpg,9,73,15,4,0,101
450063799.jpg,0,12,58,32,0,102
45015821.jpg,26,69,10,2,0,107
4501585211.jpg,22,75,10,1,0,108
4502165045.jpg,0,9,82,19,0,110
4502409601.jpg,23,61,14,1,0,99
450338979.jpg,70,31,2,0,0,103
450407660.jpg,0,16,63,34,5,118
4504123530.jpg,0,9,57,45,2,113
4504355317.jpg,0,0,15,80,7,102
4504786016.jpg,1,40,60,8,0,109
4506321902.jpg,0,3,56,37,0,96
450789020.jpg,0,31,66,7,0,104
4509028861.jpg,0,11,89,8,0,108
4510024370.jpg,0,1,40,62,2,105
4511318356.jpg,0,1,47,52,0,100
4512110934.jpg,17,51,33,1,0,102
4512123861.jpg,0,2,51,79,0,132
4512474932.jpg,0,2,33,66,2,103
4513142635.jpg,1,41,56,3,0,101
4513570407.jpg,0,0,19,75,3,97
4515471665.jpg,0,5,53,44,2,104
4515954109.jpg,32,70,5,0,0,107
451764144.jpg,0,5,56,49,2,112
4518358107.jpg,3,43,51,2,0,99
4518414673.jpg,5,38,73,9,0,125
4519546786.jpg,0,10,66,38,0,114
4520096475.jpg,0,15,60,29,2,106
4520380552.jpg,0,20,69,22,0,111
4521235979.jpg,8,36,53,9,0,106
4522459343.jpg,0,0,34,69,4,107
4524543534.jpg,0,9,65,30,2,106
4524766514.jpg,0,1,23,78,3,105
4525361026.jpg,0,4,51,41,0,96
4525459727.jpg,0,1,30,71,4,106
4525595896.jpg,0,15,80,15,0,110
4525681285.jpg,2,22,72,9,0,105
4526077589.jpg,0,3,54,48,2,107
4526456137.jpg,0,1,26,75,2,104
452671189.jpg,32,59,15,1,0,107
452715885.jpg,0,10,70,21,1,102
4528580529.jpg,0,1,36,71,1,109
4529654985.jpg,5,80,23,0,0,108
4530384020.jpg,0,7,64,36,0,107
4530875549.jpg,0,5,36,56,6,103
45323583.jpg,70,32,1,0,0,103
4532664267.jpg,5,37,60,9,0,111
4533734353.jpg,20,58,24,3,0,105
4535431418.jpg,3,24,56,20,3,106
4535544675.jpg,0,1,26,88,6,121
4535634069.jpg,0,7,59,44,0,110
4537863241.jpg,0,9,73,26,0,108
4538412115.jpg,41,61,5,0,0,107
4538779976.jpg,1,27,69,3,1,101
4539089246.jpg,0,3,56,45,0,104
4539567531.jpg,0,25,70,8,0,103
4539671181.jpg,0,1,35,72,0,108
4540896523.jpg,2,53,47,2,0,104
4541000790.jpg,0,0,17,81,10,108
4541090785.jpg,0,44,61,3,0,108
4542216557.jpg,0,0,47,53,2,102
4542866851.jpg,4,36,62,10,0,112
4543035277.jpg,0,1,31,68,3,103
4545054058.jpg,23,73,12,0,0,108
4548390935.jpg,0,0,33,69,1,103
4548596684.jpg,1,15,66,23,0,105
4549109010.jpg,0,2,48,53,0,103
4549687373.jpg,0,2,80,30,0,112
4550104555.jpg,0,3,42,51,1,97
4551121129.jpg,0,0,13,84,9,106
4551794095.jpg,0,1,41,59,2,103
4555534725.jpg,38,65,5,1,0,109
4555936051.jpg,0,0,31,73,4,108
4556815018.jpg,0,0,64,37,1,102
4556962196.jpg,0,3,60,37,0,100
4561013937.jpg,1,17,72,19,0,109
4562682674.jpg,2,58,44,6,0,110
4562998069.jpg,0,1,28,72,0,101
4563172093.jpg,0,2,38,55,4,99
456472871.jpg,0,7,59,35,4,105
4565000392.jpg,1,12,51,36,0,100
4565683087.jpg,0,2,23,72,10,107
4567181047.jpg,0,1,43,56,2,102
4567215412.jpg,1,35,59,8,0,103
4567762490.jpg,0,1,39,64,6,110
4568018818.jpg,0,0,37,69,1,107
4568150681.jpg,0,0,29,82,4,115
4570337647.jpg,1,22,70,9,0,102
4570575045.jpg,1,9,70,27,0,107
4571847379.jpg,0,23,70,14,0,107
4571937568.jpg,0,15,73,17,0,105
4572287798.jpg,1,20,69,11,1,102
4572672183.jpg,2,31,60,14,0,107
4573273622.jpg,0,1,45,54,1,101
4573303796.jpg,1,44,53,9,0,107
457397602.jpg,2,34,68,6,0,110
4574265376.jpg,2,53,46,1,0,102
4576647416.jpg,0,8,67,29,1,105
4576844747.jpg,0,4,61,43,0,108
4577459748.jpg,1,27,63,18,1,110
4578361888.jpg,0,3,70,32,0,105
4578563691.jpg,0,1,52,49,1,103
4578866514.jpg,0,1,19,85,7,112
4578965343.jpg,2,68,42,0,0,112
4579620271.jpg,0,1,49,61,2,113
4580698398.jpg,5,64,36,1,0,106
4582906874.jpg,1,21,61,18,0,101
4583125138.jpg,0,0,42,64,0,106
4583413420.jpg,0,4,49,44,0,97
4585004484.jpg,0,13,109,16,0,138
4585233162.jpg,4,43,45,11,1,104
4585460509.jpg,0,8,76,26,2,112
4586207743.jpg,0,10,54,46,0,110
4586793310.jpg,1,23,75,9,0,108
4589538888.jpg,1,41,53,6,0,101
4590098379.jpg,0,13,70,17,0,100
4591255467.jpg,1,3,76,29,0,109
4591311320.jpg,0,6,69,70,1,146
4591422965.jpg,0,2,29,69,3,103
45917867.jpg,16,79,8,0,0,103
4594091723.jpg,0,3,44,62,2,111
4594670956.jpg,0,19,66,19,1,105
4595899816.jpg,0,0,36,64,5,105
4596719098.jpg,0,18,72,18,0,108
4597162839.jpg,0,0,28,72,2,102
4597898813.jpg,1,15,62,31,0,109
4598047073.jpg,1,12,85,10,0,108
4598385226.jpg,1,18,71,17,0,107
459891743.jpg,0,0,39,55,4,98
4599648667.jpg,16,69,20,0,0,105
4600229706.jpg,1,23,65,18,0,107
460024423.jpg,0,0,32,66,3,101
460148364.jpg,1,47,67,10,0,125
4601884206.jpg,8,63,33,3,0,107
4602499723.jpg,4,35,46,18,0,103
4602555754.jpg,2,40,56,9,0,107
460276399.jpg,0,3,63,38,0,104
4602769821.jpg,0,0,20,82,5,107
4603364479.jpg,0,4,61,41,1,107
4603966605.jpg,5,74,29,2,0,110
4605015781.jpg,0,13,67,25,0,105
4605356871.jpg,0,3,62,44,2,111
4605589887.jpg,0,5,69,35,0,109
4605755313.jpg,2,33,54,16,0,105
4605842170.jpg,1,1,53,50,2,107
4606934450.jpg,0,12,71,21,0,104
460737356.jpg,1,30,68,2,0,101
4607436163.jpg,0,3,51,55,0,109
4610304834.jpg,2,49,51,5,0,107
461078499.jpg,54,55,1,0,0,110
4611014636.jpg,0,0,34,74,5,113
46116416.jpg,0,10,32,55,6,103
4611753437.jpg,3,53,55,2,0,113
461213420.jpg,57,50,1,0,0,108
4614592470.jpg,3,58,39,0,0,100
4615199637.jpg,4,64,34,1,0,103
4617163865.jpg,9,69,19,0,0,97
4617747913.jpg,1,33,62,8,0,104
4617763829.jpg,0,1,56,50,1,108
4619633197.jpg,0,0,22,72,11,105
4620749659.jpg,0,4,76,63,3,146
4622287144.jpg,0,3,25,71,3,102
4622900651.jpg,0,1,51,47,0,99
4623510365.jpg,0,6,53,46,4,109
4625855199.jpg,1,24,80,6,0,111
4625946312.jpg,5,63,36,3,1,108
4626592042.jpg,0,36,82,9,0,127
4626914740.jpg,0,0,51,51,2,104
4629048299.jpg,34,60,11,2,1,108
4630540392.jpg,0,7,45,46,10,108
4631127472.jpg,2,33,62,3,0,100
4631601517.jpg,0,27,79,3,0,109
4631640521.jpg,0,0,25,69,4,98
463199566.jpg,0,22,67,19,0,108
4632834953.jpg,0,2,59,50,0,111
4633306112.jpg,10,62,33,0,0,105
463426919.jpg,2,68,36,2,0,108
4634635214.jpg,0,12,51,39,3,105
463525569.jpg,0,2,47,49,1,99
4635702029.jpg,1,2,49,47,4,103
4636057593.jpg,0,4,61,43,0,108
4637538714.jpg,24,74,9,0,0,107
4638196012.jpg,0,1,25,82,1,109
4638688609.jpg,0,0,42,68,3,113
4638773413.jpg,0,11,57,31,7,106
4639008494.jpg,8,51,38,3,1,101
4639050491.jpg,0,5,68,27,1,101
4640205988.jpg,0,3,43,58,3,107
464118000.jpg,4,49,43,8,0,104
4643295751.jpg,1,26,99,4,0,130
4643928912.jpg,1,16,71,15,0,103
4644879921.jpg,0,12,70,21,1,104
4644913731.jpg,1,9,64,34,1,109
4647260189.jpg,0,5,37,64,1,107
4647732482.jpg,0,2,54,41,4,101
4650909917.jpg,0,1,51,55,1,108
4651317050.jpg,7,45,55,3,0,110
4651402324.jpg,0,2,41,56,3,102
4655744443.jpg,0,2,46,57,1,106
4656581279.jpg,0,1,41,66,2,110
4656808355.jpg,0,11,68,24,1,104
4658471909.jpg,15,63,24,1,0,103
4659357736.jpg,0,39,64,7,0,110
4663774613.jpg,0,1,32,71,3,107
466432603.jpg,1,13,76,17,0,107
4664658605.jpg,0,8,69,29,0,106
46658329.jpg,0,29,45,25,2,101
46667675.jpg,3,48,49,7,0,107
4668385279.jpg,0,1,58,45,1,105
4668832694.jpg,0,0,54,52,0,106
4668889560.jpg,0,4,51,47,0,102
4668901744.jpg,0,1,40,65,3,109
4669146975.jpg,2,46,59,0,0,107
4669754441.jpg,0,0,26,75,3,104
4670475171.jpg,0,0,16,83,8,107
4670590256.jpg,0,4,77,27,0,108
4671382441.jpg,0,0,30,69,5,104
4671409819.jpg,0,39,60,12,0,111
4671787703.jpg,0,4,63,38,0,105
4672698013.jpg,0,2,34,62,3,101
4672766619.jpg,0,2,28,71,2,103
4673438844.jpg,0,1,26,71,6,104
4673878145.jpg,0,11,61,29,0,101
4674436980.jpg,0,1,42,67,2,112
4674618399.jpg,0,17,59,32,0,108
4674790248.jpg,0,2,37,65,1,105
4676269978.jpg,0,0,24,72,8,104
4676525770.jpg,0,44,52,10,0,106
46766983.jpg,17,62,21,2,0,102
4676944717.jpg,4,54,45,2,0,105
4679147725.jpg,0,0,48,53,4,105
4680082599.jpg,0,1,18,79,7,105
4681215652.jpg,0,6,54,48,0,108
4681329966.jpg,0,6,38,57,9,110
4682349014.jpg,0,33,55,17,0,105
4682743182.jpg,6,55,37,3,0,101
4683130999.jpg,0,5,64,36,1,106
4683892759.jpg,0,16,74,11,0,101
468518360.jpg,0,5,55,41,0,101
468574107.jpg,34,61,6,1,0,102
4685744038.jpg,0,1,27,62,10,100
4687542962.jpg,0,22,72,13,0,107
468764619.jpg,1,10,58,32,0,101
4688027801.jpg,0,18,56,29,0,103
4688672987.jpg,0,12,56,38,0,106
4688942670.jpg,0,6,56,41,3,106
4689159899.jpg,10,84,11,0,0,105
4689181626.jpg,0,29,58,11,0,98
469009898.jpg,0,6,65,28,0,99
4690644950.jpg,0,4,53,49,0,106
4690684792.jpg,0,9,68,33,0,110
4691973869.jpg,11,56,30,4,0,101
4692095992.jpg,0,9,75,17,0,101
4692485168.jpg,0,4,52,53,1,110
4693844054.jpg,0,13,70,19,0,102
4694563082.jpg,0,3,35,61,7,106
4696097531.jpg,0,7,60,39,0,106
4696239138.jpg,0,1,37,70,1,109
4696642475.jpg,0,1,51,50,4,106
4697031191.jpg,0,7,66,31,0,104
4697661900.jpg,1,7,49,44,3,104
4698449914.jpg,2,47,79,2,0,130
469890496.jpg,1,13,63,26,1,104
4698931028.jpg,0,3,61,48,0,112
4699352200.jpg,0,2,42,62,1,107
4699474732.jpg,1,20,65,16,0,102
4701833798.jpg,0,4,62,37,0,103
4702275189.jpg,0,3,45,54,2,104
470258883.jpg,2,33,59,13,0,107
4702733058.jpg,0,6,62,34,1,103
4702824874.jpg,0,31,65,6,0,102
4704193975.jpg,0,21,64,18,0,103
4704223777.jpg,0,1,45,51,0,97
4704686099.jpg,0,23,74,5,0,102
4704859608.jpg,5,66,31,2,0,104
4705856366.jpg,0,15,67,24,0,106
4706726398.jpg,3,42,61,2,0,108
4707334942.jpg,0,4,46,59,1,110
4708680413.jpg,0,8,70,28,0,106
47095522.jpg,0,6,46,51,4,107
4710464067.jpg,0,0,31,65,5,101
4711101546.jpg,0,3,67,33,0,103
4711939216.jpg,3,88,18,3,0,112
4712201579.jpg,0,1,35,61,5,102
4713092038.jpg,0,1,29,74,4,108
4714778162.jpg,0,0,67,35,1,103
4714961173.jpg,0,9,53,44,2,108
4718032191.jpg,0,9,78,25,0,112
4718226346.jpg,0,19,73,14,1,107
4718542749.jpg,0,12,74,22,0,108
4719295519.jpg,0,31,68,8,0,107
4719558314.jpg,22,77,10,0,0,109
4722268334.jpg,0,1,42,63,1,107
4722272826.jpg,0,4,47,98,4,153
4722588778.jpg,0,2,28,67,5,102
4725670933.jpg,0,3,69,33,0,105
4725890838.jpg,1,19,69,14,1,104
4726274782.jpg,19,83,12,0,0,114
4727744330.jpg,0,1,31,79,1,112
4728497082.jpg,0,0,47,59,1,107
4728646090.jpg,30,72,9,0,0,111
4728690118.jpg,0,1,21,74,10,106
4730475136.jpg,3,23,67,13,1,107
4730781966.jpg,11,64,23,0,0,98
4731015701.jpg,0,15,77,18,0,110
4731319039.jpg,4,57,37,1,0,99
4731330377.jpg,1,27,59,21,0,108
4732322374.jpg,0,2,17,78,8,105
4732496293.jpg,0,21,68,10,0,99
4733042196.jpg,0,2,25,83,3,113
4733189524.jpg,0,15,91,11,1,118
4735563555.jpg,0,1,54,50,0,105
473566328.jpg,0,5,46,53,4,108
4737751146.jpg,0,1,46,53,1,101
4737850701.jpg,0,13,65,26,3,107
473881316.jpg,37,64,4,0,0,105
4738960229.jpg,7,63,29,0,0,99
4739066142.jpg,0,1,20,85,5,111
4739558783.jpg,0,7,55,40,0,102
474070389.jpg,0,0,13,81,4,98
4740901654.jpg,0,27,90,16,1,134
4742025728.jpg,0,7,64,39,0,110
4743492963.jpg,0,46,51,3,0,100
4743830608.jpg,0,3,67,55,0,125
4745213797.jpg,0,1,26,69,4,100
4746340677.jpg,1,4,94,33,0,132
4747712670.jpg,1,6,63,34,2,106
4748697171.jpg,2,48,53,4,0,107
4748829159.jpg,1,20,72,14,0,107
4750416133.jpg,0,7,50,50,2,109
4750521580.jpg,0,0,17,79,7,103
4752962359.jpg,0,5,78,22,0,105
4757093692.jpg,0,2,47,50,2,101
4757384229.jpg,3,58,44,2,0,107
475853335.jpg,16,85,32,1,0,134
47612135.jpg,0,10,46,45,6,107
4761802851.jpg,2,27,63,10,0,102
4761960995.jpg,0,18,67,19,0,104
4764407251.jpg,1,24,55,26,2,108
4764540278.jpg,0,5,50,53,3,111
4764809752.jpg,0,14,76,24,0,114
4765706226.jpg,0,2,34,59,6,101
4765708291.jpg,1,2,34,65,9,111
4766339964.jpg,0,12,47,45,4,108
4767640691.jpg,0,36,61,0,0,97
4769301151.jpg,9,58,34,2,0,103
4770124841.jpg,0,8,70,36,1,115
4770169005.jpg,0,0,44,60,4,108
4770545465.jpg,0,1,37,66,4,108
4770991170.jpg,0,16,55,30,1,102
4771924563.jpg,0,12,70,18,0,100
4772591404.jpg,1,7,63,35,2,108
4773063971.jpg,0,18,75,15,0,108
4773302631.jpg,0,11,57,36,0,104
4774195402.jpg,0,0,21,83,4,108
4777018149.jpg,0,1,41,57,2,101
4777807371.jpg,0,6,70,29,1,106
4778402744.jpg,0,3,46,50,2,101
4778495597.jpg,0,17,72,18,0,107
477928479.jpg,0,36,67,6,0,109
477939756.jpg,0,0,34,67,2,103
4780164434.jpg,0,10,73,22,0,105
4780450043.jpg,0,1,57,43,2,103
4781142781.jpg,1,22,57,30,1,111
4781552174.jpg,0,4,50,47,1,102
4782504809.jpg,0,6,39,58,0,103
4782546865.jpg,0,2,55,55,1,113
4782608700.jpg,2,15,77,18,0,112
4782637866.jpg,0,1,30,74,1,106
4782987041.jpg,0,0,19,76,14,109
4784361629.jpg,1,6,63,29,0,99
4786690796.jpg,4,67,42,1,0,114
4787504766.jpg,0,6,72,30,0,108
4787556835.jpg,0,3,51,53,0,107
4788033646.jpg,0,1,18,88,3,110
4789129778.jpg,0,5,69,27,0,101
4791175187.jpg,0,9,61,36,1,107
4792717107.jpg,0,2,50,51,1,104
4794011269.jpg,0,0,44,61,1,106
4794298678.jpg,0,5,59,43,0,107
4794780770.jpg,0,4,75,32,0,111
4795531186.jpg,0,0,57,47,1,105
4796228876.jpg,0,1,43,62,2,108
4800263969.jpg,0,13,75,15,0,103
4801184295.jpg,0,4,37,63,4,108
4801726337.jpg,0,13,72,16,0,101
4803889024.jpg,1,21,64,22,0,108
4804088480.jpg,0,5,53,41,0,99
4804146129.jpg,4,43,51,4,0,102
4804146646.jpg,0,2,20,74,4,100
4804414192.jpg,0,4,60,41,0,105
4805041131.jpg,0,11,63,27,0,101
4805501528.jpg,1,3,60,46,1,111
4806036650.jpg,46,43,11,3,0,103
4806110659.jpg,0,3,68,27,2,100
480626798.jpg,15,84,11,0,0,110
4806281586.jpg,0,17,66,22,0,105
4806591146.jpg,1,13,74,19,0,107
4808255488.jpg,0,2,31,72,0,105
4809080599.jpg,0,0,24,85,2,111
4814084144.jpg,0,5,66,35,0,106
4815901200.jpg,0,1,23,61,21,106
4819833644.jpg,19,88,6,0,0,113
4819847439.jpg,19,63,22,3,0,107
4820110338.jpg,0,13,77,12,0,102
482147713.jpg,0,4,32,68,1,105
4822559131.jpg,1,24,65,16,0,106
4822674187.jpg,0,11,96,10,0,117
4822965011.jpg,0,4,59,39,2,104
4824776407.jpg,0,2,29,74,0,105
4826544292.jpg,5,53,51,4,0,113
4828138245.jpg,1,68,40,2,0,111
4828896285.jpg,0,2,45,64,11,122
4830054430.jpg,0,5,39,61,1,106
4830420359.jpg,0,12,74,21,0,107
4831070004.jpg,59,42,3,0,0,104
483164670.jpg,3,49,56,2,0,110
4835256174.jpg,0,0,15,85,7,107
4835865863.jpg,0,11,74,17,0,102
483591009.jpg,0,3,66,34,0,103
4837135935.jpg,0,3,59,38,1,101
4837286609.jpg,0,0,22,77,5,104
4838893362.jpg,1,13,65,24,0,103
4840518597.jpg,0,15,59,26,1,101
4841257153.jpg,1,17,70,19,0,107
4842717407.jpg,0,3,66,33,0,102
4843346384.jpg,0,14,60,32,0,106
4843845900.jpg,1,22,69,12,0,104
4845155288.jpg,0,6,67,28,2,103
4845527109.jpg,1,1,29,75,8,114
4845803922.jpg,1,68,41,1,0,111
4845997437.jpg,0,32,61,12,0,105
4846003639.jpg,1,11,94,19,0,125
4847778477.jpg,0,2,34,72,0,108
4847844430.jpg,0,1,45,54,1,101
4847954914.jpg,1,20,91,17,0,129
4848345613.jpg,0,1,36,78,4,119
484860366.jpg,18,58,23,8,0,107
4850291252.jpg,1,59,43,1,0,104
4851066149.jpg,6,69,36,1,0,112
4851467262.jpg,0,4,50,42,4,100
485174290.jpg,0,1,45,58,0,104
4851762296.jpg,1,12,66,19,0,98
4852617544.jpg,0,0,46,58,0,104
4852968688.jpg,0,6,65,32,0,103
4854909641.jpg,11,55,38,5,0,109
4855511701.jpg,0,30,65,6,0,101
4856036467.jpg,0,2,34,57,8,101
4857542718.jpg,0,0,32,66,6,104
4858031538.jpg,2,48,52,7,0,109
4858527470.jpg,0,29,71,7,1,108
486068453.jpg,5,42,57,9,0,113
486170909.jpg,0,13,74,16,1,104
4862383971.jpg,0,3,63,40,0,106
4862615903.jpg,0,5,52,45,1,103
4863093063.jpg,2,43,57,3,0,105
4864265547.jpg,0,0,64,42,0,106
4866523929.jpg,0,5,52,53,2,112
4867071134.jpg,0,5,56,40,3,104
4867659714.jpg,0,9,66,32,0,107
4867994945.jpg,30,75,5,0,0,110
4868050690.jpg,0,0,27,83,1,111
4868558209.jpg,3,43,52,4,0,102
4868895324.jpg,0,3,30,65,3,101
4870809935.jpg,0,0,17,86,7,110
4871159312.jpg,0,5,48,44,0,97
4871407891.jpg,0,8,68,33,0,109
4871444135.jpg,0,1,40,61,4,106
4871847706.jpg,0,1,27,69,8,105
4872116932.jpg,1,37,58,3,0,99
4873047491.jpg,0,0,35,70,7,112
4875935356.jpg,0,18,78,29,1,126
4875993491.jpg,0,4,56,42,1,103
4877994171.jpg,1,15,65,21,2,104
487860600.jpg,50,62,0,0,0,112
4880270138.jpg,0,3,52,47,3,105
4881913692.jpg,0,0,29,72,7,108
4882295000.jpg,0,0,31,70,3,104
4882358476.jpg,0,2,60,45,2,109
4882465125.jpg,5,73,31,0,0,109
4882952027.jpg,0,9,69,23,0,101
4883254364.jpg,0,1,44,54,2,101
4883647933.jpg,0,9,72,25,0,106
4883939911.jpg,19,87,22,0,0,128
4885160336.jpg,0,2,30,68,5,105
4885242381.jpg,2,6,48,43,2,101
4885928195.jpg,0,13,83,9,0,105
4886153819.jpg,1,6,56,38,1,102
4886277173.jpg,12,69,22,0,0,103
4886518096.jpg,1,25,69,13,0,108
4886525195.jpg,0,7,80,20,1,108
4887400905.jpg,0,3,64,33,2,102
4887754576.jpg,0,21,73,10,0,104
488823133.jpg,1,4,53,36,2,96
4889658118.jpg,0,2,40,53,1,96
4889890723.jpg,0,11,63,26,1,101
4890086996.jpg,0,4,76,28,0,108
4890155523.jpg,0,2,57,85,2,146
4891468275.jpg,0,1,21,68,16,106
4891817119.jpg,0,1,39,61,2,103
4893296719.jpg,0,11,55,38,0,104
4894150529.jpg,0,2,34,61,2,99
4895451556.jpg,0,0,26,77,8,111
489975423.jpg,0,1,40,57,9,107
4900369405.jpg,0,10,66,30,0,106
4900565313.jpg,1,32,63,9,0,105
4900640591.jpg,0,4,74,27,1,106
4901671249.jpg,1,32,66,6,0,105
4902129359.jpg,0,0,27,69,5,101
4902504109.jpg,30,65,15,0,0,110
4903384785.jpg,0,9,58,41,0,108
4903418699.jpg,1,30,59,17,1,108
4904294830.jpg,0,3,43,65,2,113
4905609957.jpg,1,29,71,4,0,105
4905995730.jpg,0,1,16,73,10,100
4906359700.jpg,0,1,25,74,3,103
4906429431.jpg,0,0,19,74,16,109
4906735319.jpg,0,0,25,68,6,99
4906902596.jpg,0,5,74,31,1,111
4907748522.jpg,0,6,58,47,0,111
4907901600.jpg,0,3,43,55,3,104
4908270930.jpg,0,31,65,4,0,100
4908441792.jpg,2,32,66,7,0,107
4909946838.jpg,0,0,50,61,0,111
4910377121.jpg,6,79,15,0,0,100
4911877298.jpg,0,14,62,26,0,102
4911990100.jpg,1,11,106,12,0,130
4912317009.jpg,0,0,30,69,5,104
4912437730.jpg,1,1,19,72,11,104
4913587642.jpg,0,0,32,73,6,111
4915971389.jpg,0,29,62,13,0,104
4918086314.jpg,0,3,51,51,2,107
491839128.jpg,7,67,34,0,0,108
4918979865.jpg,0,1,46,57,1,105
4919695267.jpg,1,20,65,23,1,110
4920401436.jpg,1,49,82,1,0,133
4920539113.jpg,0,0,35,72,4,111
4921474940.jpg,0,5,64,37,1,107
4921721859.jpg,0,4,50,47,2,103
4921823031.jpg,0,1,48,57,0,106
4922516594.jpg,0,44,55,7,0,106
4922576334.jpg,0,2,55,48,3,108
4922763994.jpg,0,9,63,28,0,100
4922860865.jpg,3,28,61,11,0,103
4922892935.jpg,0,0,27,73,4,104
4923216773.jpg,0,1,39,60,6,106
4923537063.jpg,0,8,68,23,2,101
4924398774.jpg,4,26,58,18,0,106
4925153617.jpg,0,1,52,53,0,106
4925167261.jpg,0,7,64,35,0,106
4925344781.jpg,0,1,33,68,3,105
4926447658.jpg,0,6,71,23,0,100
4926787829.jpg,0,17,65,20,1,103
492751146.jpg,1,17,57,25,0,100
4930262989.jpg,0,9,53,47,2,111
493128717.jpg,0,1,58,51,0,110
4931966065.jpg,1,30,62,11,0,104
4932130784.jpg,1,2,59,47,0,109
4932950485.jpg,0,36,54,6,0,96
4933863195.jpg,1,26,71,7,1,106
4935990245.jpg,0,10,66,24,0,100
4936086328.jpg,0,0,34,70,2,106
4937662029.jpg,0,2,44,58,0,104
4938188075.jpg,5,28,51,17,0,101
494015270.jpg,1,23,59,17,0,100
4940371977.jpg,0,2,52,48,2,104
4940996206.jpg,0,0,54,52,0,106
4941076531.jpg,0,4,55,44,1,104
4941401132.jpg,0,0,23,72,10,105
4941443673.jpg,0,4,66,41,0,111
4942239073.jpg,0,13,86,11,0,110
494236256.jpg,0,54,44,2,0,100
4943600012.jpg,0,6,48,45,4,103
49445241.jpg,0,31,66,11,1,109
4944793972.jpg,0,5,74,20,1,100
4945508144.jpg,2,16,75,13,0,106
4947244.jpg,5,69,31,4,0,109
4947500856.jpg,0,1,36,68,0,105
4947572555.jpg,0,1,53,43,3,100
4948021193.jpg,1,4,60,44,2,111
4948125167.jpg,0,9,44,48,2,103
4949714700.jpg,0,6,65,30,0,101
4950276392.jpg,2,54,50,1,0,107
4950643421.jpg,0,3,59,36,3,101
4952399474.jpg,0,11,76,24,0,111
4953282690.jpg,73,25,8,1,0,107
4953733701.jpg,0,0,12,73,21,106
4953755434.jpg,0,14,65,22,0,101
4954115704.jpg,0,11,78,44,0,133
4954209731.jpg,3,31,63,2,0,99
4955052105.jpg,0,6,67,33,0,106
4955674278.jpg,0,12,111,29,0,152
4958359048.jpg,0,0,69,39,0,108
4958737471.jpg,0,5,62,41,0,108
4960025889.jpg,1,25,77,6,0,109
4960147659.jpg,6,50,40,9,0,105
4960586032.jpg,0,18,63,23,0,104
496109303.jpg,3,35,66,7,0,111
4961168084.jpg,0,2,39,71,2,114
4961486371.jpg,1,6,61,40,3,111
496162577.jpg,4,35,64,7,0,110
4962117985.jpg,9,67,30,1,0,107
4962875195.jpg,0,3,32,66,3,104
4965455693.jpg,1,22,75,6,0,104
4965802871.jpg,8,44,55,2,0,109
4965946284.jpg,1,18,100,6,0,125
4966132108.jpg,0,20,63,22,0,105
4966811903.jpg,0,7,56,44,2,109
4967412135.jpg,0,3,49,51,1,104
4968475623.jpg,0,15,71,29,0,115
4969822064.jpg,0,10,71,20,0,101
497163401.jpg,0,0,35,68,3,106
4972378781.jpg,0,1,28,74,3,106
4972553952.jpg,0,1,65,42,0,108
4972615412.jpg,6,59,40,3,0,108
4973124317.jpg,0,14,59,32,0,105
497525662.jpg,0,31,102,8,1,142
4975468754.jpg,0,3,52,44,2,101
4975653682.jpg,0,0,37,66,4,107
4975773859.jpg,0,0,21,73,13,107
4975990286.jpg,0,5,39,48,9,101
4976142964.jpg,0,17,68,13,0,98
4976232823.jpg,0,2,32,67,2,103
4976269857.jpg,0,0,18,90,2,110
4976501337.jpg,0,6,55,49,0,110
4978032841.jpg,11,88,11,0,0,110
4979420600.jpg,0,4,73,33,0,110
4979581696.jpg,0,4,82,43,0,129
4980059014.jpg,0,8,73,22,1,104
4980829250.jpg,27,56,16,7,0,106
4981035833.jpg,0,0,41,59,2,102
4981184708.jpg,0,12,80,14,0,106
4982428461.jpg,0,5,59,42,0,106
4982617348.jpg,0,10,84,14,0,108
498265046.jpg,1,66,42,0,0,109
4983471695.jpg,0,8,61,38,1,108
4984086049.jpg,23,62,17,0,0,102
4985059388.jpg,0,1,28,73,4,106
4985166775.jpg,1,7,59,40,0,107
4985465789.jpg,0,5,89,37,0,131
4985988258.jpg,0,18,62,27,0,107
4986076377.jpg,0,2,49,50,0,101
4986510349.jpg,26,77,8,0,0,111
4986682017.jpg,51,49,2,0,0,102
4987072948.jpg,0,6,77,45,0,128
4987191446.jpg,16,83,11,1,0,111
4987318624.jpg,2,44,56,5,0,107
49874259.jpg,0,9,54,45,1,109
4988320464.jpg,0,2,38,73,0,113
4989044190.jpg,0,2,55,51,2,110
4989495161.jpg,0,0,23,78,8,109
499095228.jpg,0,1,11,66,23,101
4991407708.jpg,0,2,44,59,4,109
4991538106.jpg,0,10,57,34,1,102
4991939718.jpg,0,6,72,24,0,102
4992884384.jpg,0,1,33,79,0,113
4994678050.jpg,0,3,57,59,1,120
4995010778.jpg,2,11,59,29,1,102
4995119944.jpg,0,1,40,63,1,105
4996107093.jpg,0,1,25,79,1,106
4996581735.jpg,0,0,13,82,15,110
4996783204.jpg,0,0,23,77,1,101
4996914779.jpg,0,20,65,14,1,100
4999850616.jpg,2,34,62,5,0,103
5000010668.jpg,1,11,58,26,1,97
5000264687.jpg,1,17,71,17,0,106
500101169.jpg,0,0,33,63,7,103
5001067426.jpg,0,4,46,57,4,111
50012842.jpg,0,0,31,58,20,109
5001626870.jpg,31,69,7,0,0,107
5001719293.jpg,5,56,42,3,0,106
5001805928.jpg,3,40,57,1,0,101
5001866078.jpg,0,7,74,58,1,140
5003189524.jpg,0,1,36,62,3,102
5003482891.jpg,0,1,53,52,0,106
5004699048.jpg,0,0,48,57,3,108
5005406987.jpg,0,2,55,46,3,106
5005558786.jpg,0,0,44,53,7,104
5005908077.jpg,0,3,55,43,5,106
5007844069.jpg,1,26,60,18,0,105
500876950.jpg,0,3,37,53,11,104
5008940426.jpg,0,6,80,26,0,112
5010052937.jpg,0,1,21,70,8,100
5012894248.jpg,0,3,60,41,1,105
5013129486.jpg,0,3,55,45,1,104
5013265495.jpg,0,1,38,67,1,107
5013613228.jpg,0,1,49,54,1,105
5014526130.jpg,0,0,67,62,0,129
5014551340.jpg,0,0,37,67,1,105
5016016369.jpg,0,0,52,53,2,107
5016420324.jpg,0,6,54,43,1,104
5016657118.jpg,2,28,92,7,0,129
501669092.jpg,10,78,17,0,0,105
5016823142.jpg,1,26,60,11,0,98
5017205636.jpg,0,8,66,34,0,108
5017257541.jpg,0,7,60,80,5,152
5017267795.jpg,0,7,91,36,0,134
5017618497.jpg,0,2,52,53,2,109
5018846919.jpg,1,30,69,7,0,107
5021524796.jpg,0,2,56,45,1,104
502182808.jpg,0,1,23,76,1,101
5022600998.jpg,0,0,31,73,3,107
5022993325.jpg,1,6,39,53,3,102
5023353600.jpg,0,22,73,12,1,108
502416007.jpg,4,55,43,3,0,105
5024762120.jpg,0,0,24,71,5,100
5025588176.jpg,0,2,45,59,3,109
5026427468.jpg,0,5,62,37,1,105
5027216651.jpg,0,3,55,49,0,107
5027281781.jpg,0,5,48,55,0,108
5027882580.jpg,0,0,30,59,18,107
5028374263.jpg,10,60,27,2,0,99
5028389463.jpg,1,31,60,13,0,105
5028571969.jpg,0,6,68,30,0,104
5032381168.jpg,4,55,39,5,0,103
503291895.jpg,0,7,61,44,0,112
5032946224.jpg,3,51,51,4,0,109
503496072.jpg,0,15,61,24,0,100
5034975248.jpg,0,13,50,41,4,108
5035645781.jpg,0,8,76,26,0,110
5036248276.jpg,0,3,62,34,2,101
5036262446.jpg,0,1,45,53,1,100
5036806312.jpg,0,47,56,0,0,103
5037000610.jpg,0,3,34,66,0,103
5037503230.jpg,0,4,71,32,0,107
5038562159.jpg,0,0,35,70,1,106
5038604558.jpg,0,0,16,77,12,105
5040119968.jpg,1,61,38,0,0,100
5040602393.jpg,0,18,61,22,0,101
5040853192.jpg,25,67,12,1,0,105
5041593593.jpg,4,29,51,17,0,101
5043851130.jpg,7,50,39,6,0,102
5044457387.jpg,0,5,83,38,2,128
5047082376.jpg,0,6,54,41,1,102
5050399849.jpg,0,12,111,7,0,130
5051600612.jpg,0,8,56,40,5,109
5053500577.jpg,0,3,57,43,1,104
5055213857.jpg,0,31,74,6,0,111
5056056125.jpg,0,7,41,47,3,98
5056738651.jpg,1,3,37,60,5,106
5058312922.jpg,0,11,77,15,0,103
5058695994.jpg,0,1,13,73,20,107
5059274251.jpg,0,6,62,27,1,96
5059626281.jpg,1,19,78,11,0,109
5060000840.jpg,0,2,25,74,2,103
5060158839.jpg,0,13,68,17,0,98
5060270217.jpg,1,4,72,28,0,105
5062026548.jpg,4,47,50,4,0,105
5062110567.jpg,0,25,77,6,0,108
5062330348.jpg,0,1,58,46,1,106
5063711541.jpg,1,14,70,24,0,109
5064165053.jpg,0,1,29,76,8,114
5064176245.jpg,0,0,25,68,10,103
5064264405.jpg,0,13,67,28,0,108
5064418031.jpg,2,48,49,0,0,99
5064515429.jpg,1,20,104,27,0,152
5064578225.jpg,0,4,48,48,1,101
5064823395.jpg,1,44,54,1,0,100
5065354809.jpg,0,3,71,55,0,129
5066476555.jpg,0,0,19,81,6,106
5067206886.jpg,8,56,35,1,0,100
5068225832.jpg,0,16,111,10,0,137
5069309990.jpg,20,74,10,0,0,104
5070455487.jpg,0,0,50,54,1,105
5071049710.jpg,0,24,67,15,2,108
5071912841.jpg,0,4,58,40,3,105
5073500906.jpg,0,9,59,33,1,102
5073566975.jpg,0,9,77,25,0,111
5073919092.jpg,0,26,74,6,0,106
5074508109.jpg,0,8,79,14,0,101
507507455.jpg,0,2,43,59,4,108
5075275205.jpg,0,3,35,82,0,120
5076506.jpg,0,3,30,67,7,107
5077869968.jpg,1,50,52,5,0,108
5078692396.jpg,0,5,40,65,0,110
5078922181.jpg,0,11,78,20,0,109
5079448176.jpg,0,0,51,52,5,108
5081374671.jpg,3,42,52,6,0,103
5081637571.jpg,0,25,71,11,0,107
5082407583.jpg,0,11,117,11,1,140
5082552221.jpg,2,69,41,2,0,114
5083127743.jpg,0,1,36,63,2,102
5083763203.jpg,0,44,55,4,0,103
5086754457.jpg,0,2,57,38,1,98
5090001239.jpg,0,10,58,29,0,97
5090174589.jpg,5,82,20,0,0,107
5090549164.jpg,0,3,57,44,2,106
5090550218.jpg,0,4,65,35,2,106
5090803058.jpg,0,13,67,23,0,103
5091406011.jpg,0,2,38,56,4,100
5091924028.jpg,14,66,16,0,0,96
5092945872.jpg,9,84,15,0,0,108
5094262203.jpg,0,2,42,62,0,106
5094631896.jpg,0,7,66,26,2,101
5095300668.jpg,0,2,26,76,7,111
5095808820.jpg,5,65,37,3,0,110
5096803300.jpg,0,2,63,64,0,129
5097068931.jpg,0,0,17,84,7,108
5097561600.jpg,0,2,41,59,9,111
5097621606.jpg,0,4,61,34,1,100
5098218882.jpg,3,62,34,7,0,106
5098219464.jpg,10,44,53,2,0,109
5099738809.jpg,0,2,62,37,2,103
5101081807.jpg,0,0,27,70,4,101
5101108569.jpg,2,42,50,10,0,104
5103528737.jpg,11,62,29,2,0,104
5104334034.jpg,0,3,44,54,0,101
5105331099.jpg,44,57,5,0,0,106
5106008666.jpg,0,1,67,32,3,103
510686957.jpg,0,12,71,24,0,107
5107410477.jpg,1,9,74,16,0,100
5107763844.jpg,0,5,56,44,0,105
5113314470.jpg,0,10,74,17,0,101
5114869072.jpg,0,0,34,69,3,106
5115371206.jpg,0,5,72,25,0,102
5115968572.jpg,0,6,58,40,1,105
5116959473.jpg,0,1,15,85,5,106
5117589590.jpg,0,1,45,55,3,104
5118376207.jpg,0,4,66,30,3,103
5118419705.jpg,0,19,61,22,1,103
5119374431.jpg,1,16,78,6,1,102
5119867805.jpg,0,33,84,4,0,121
5120849681.jpg,7,56,36,4,0,103
5121229620.jpg,6,36,65,5,0,112
5121622263.jpg,0,0,31,78,2,111
5122027937.jpg,0,4,54,47,2,107
5122879673.jpg,1,18,65,20,3,107
5124180488.jpg,0,0,13,91,3,107
5124446081.jpg,0,6,58,36,6,106
5125398207.jpg,0,4,78,56,0,138
5125486524.jpg,4,49,49,11,0,113
5128049833.jpg,1,27,82,9,0,119
5128108683.jpg,0,1,49,52,0,102
5128756378.jpg,0,0,11,81,16,108
5129080312.jpg,10,79,21,1,0,111
5129172.jpg,42,60,5,0,0,107
5129204001.jpg,0,15,69,15,0,99
5129872416.jpg,0,1,50,48,3,102
5130720224.jpg,0,0,34,63,4,101
5130906829.jpg,0,5,72,31,1,109
513128907.jpg,0,0,7,86,15,108
5131861392.jpg,0,4,59,44,0,107
5132091056.jpg,8,44,51,4,0,107
5133576528.jpg,2,56,42,4,0,104
5134748445.jpg,0,3,64,41,0,108
5135451445.jpg,0,13,83,13,0,109
5135908583.jpg,20,74,19,0,0,113
5135958105.jpg,5,25,61,9,1,101
5136366226.jpg,0,1,55,69,0,125
5137221601.jpg,0,48,58,6,0,112
513723164.jpg,1,13,73,16,0,103
5137508075.jpg,0,10,57,33,1,101
5137971670.jpg,6,69,31,0,0,106
5138080527.jpg,0,4,52,51,0,107
5138115166.jpg,3,14,48,34,2,101
5138308179.jpg,1,54,42,7,0,104
5139553196.jpg,0,2,36,65,4,107
5140426630.jpg,7,63,35,0,0,105
5140673192.jpg,0,7,87,17,0,111
5141696799.jpg,0,2,49,53,2,106
5142063764.jpg,4,55,61,3,0,123
5142391146.jpg,1,25,76,6,0,108
5143292163.jpg,0,10,59,25,1,95
51433626.jpg,6,49,45,9,0,109
5143740294.jpg,0,5,73,27,0,105
5144117619.jpg,5,50,46,9,0,110
5144938786.jpg,0,0,33,73,2,108
514498047.jpg,0,9,80,20,0,109
5146023515.jpg,0,5,73,57,3,138
5146611755.jpg,0,31,64,8,0,103
5147986874.jpg,0,3,46,54,1,104
5149778996.jpg,1,26,66,16,0,109
5149825714.jpg,0,6,67,36,1,110
5150554440.jpg,1,25,71,11,0,108
5150999709.jpg,4,49,47,7,0,107
5153880006.jpg,0,0,38,59,1,98
5153889058.jpg,0,2,62,48,2,114
5155188582.jpg,1,15,61,21,0,98
5156974621.jpg,5,68,25,3,0,101
5157059497.jpg,0,3,74,30,0,107
5158391010.jpg,0,5,68,32,0,105
5158556376.jpg,0,3,52,49,2,106
5158846580.jpg,4,53,41,2,0,100
5158869275.jpg,0,36,108,8,0,152
5159845899.jpg,0,2,69,36,0,107
5162032167.jpg,1,20,80,4,0,105
5164262533.jpg,1,3,55,42,2,103
5165838001.jpg,0,0,43,67,1,111
5166185394.jpg,0,4,67,31,1,103
5166352802.jpg,0,25,89,14,0,128
5166736586.jpg,0,1,22,77,11,111
5167059215.jpg,0,0,25,68,5,98
516784418.jpg,0,2,39,61,8,110
5168340748.jpg,0,4,52,48,2,106
5168834860.jpg,0,0,9,71,30,110
5170784567.jpg,1,27,73,5,0,106
5170785709.jpg,1,4,62,35,0,102
5170858607.jpg,1,4,57,41,0,103
5170894682.jpg,0,15,59,28,0,102
5172023888.jpg,0,4,78,27,0,109
5172112194.jpg,3,66,58,2,0,129
5172565267.jpg,0,49,49,7,0,105
5172812012.jpg,0,8,97,16,0,121
5173344304.jpg,0,5,58,42,2,107
517369320.jpg,0,5,101,25,0,131
5174677992.jpg,0,29,69,9,0,107
5174701484.jpg,2,8,82,15,0,107
5175429795.jpg,0,0,35,70,0,105
5176288733.jpg,0,0,37,59,4,100
5176681750.jpg,0,3,48,54,2,107
5177150402.jpg,4,48,48,4,0,104
517716589.jpg,0,0,21,75,14,110
5177309012.jpg,0,2,46,59,3,110
5177662225.jpg,0,9,52,47,2,110
5179986164.jpg,0,24,60,14,0,98
5180032640.jpg,0,2,60,42,3,107
5180679952.jpg,0,8,71,24,1,104
518080817.jpg,0,9,64,30,0,103
5182390374.jpg,0,20,72,8,0,100
5183223776.jpg,0,2,39,59,5,105
5183838812.jpg,1,52,48,6,0,107
5184506144.jpg,0,1,17,70,19,107
5184701000.jpg,20,69,20,0,0,109
5185255513.jpg,0,0,57,71,3,131
5186117445.jpg,13,101,26,0,0,140
5186392915.jpg,6,30,63,3,0,102
5187199880.jpg,0,5,57,42,1,105
5188165911.jpg,0,0,27,75,5,107
518876891.jpg,7,71,31,0,0,109
5189289022.jpg,0,2,21,68,11,102
5189402195.jpg,0,30,63,11,0,104
5189469288.jpg,9,76,36,0,0,121
5189916555.jpg,0,23,63,16,0,102
5190438831.jpg,0,7,72,30,0,109
5190675640.jpg,0,3,37,67,3,110
5191833722.jpg,11,60,30,4,0,105
5192051586.jpg,0,18,98,14,0,130
5192151844.jpg,0,1,42,56,0,99
5192516842.jpg,1,31,60,11,0,103
5193757906.jpg,0,12,67,26,2,107
5193876375.jpg,3,59,41,2,0,105
5195185160.jpg,0,0,48,51,2,101
5195283750.jpg,0,1,61,33,2,97
5195745450.jpg,1,18,55,19,5,98
5196364865.jpg,0,0,50,51,1,102
5197308883.jpg,0,5,41,53,7,106
5197338148.jpg,0,3,36,54,3,96
5197644731.jpg,0,12,70,21,0,103
5197869977.jpg,26,70,8,0,0,104
5198260109.jpg,0,5,68,25,2,100
5198400630.jpg,0,14,64,23,1,102
5199036142.jpg,10,74,24,2,0,110
5200236444.jpg,0,6,57,42,2,107
5200584536.jpg,0,34,65,6,0,105
5202282320.jpg,0,1,22,71,6,100
5204128955.jpg,0,24,66,15,2,107
5204782737.jpg,0,30,69,3,0,102
5204945276.jpg,0,2,39,67,3,111
5205048751.jpg,0,5,60,47,2,114
5205821036.jpg,2,41,55,6,0,104
5206995557.jpg,1,33,64,8,0,106
5209102120.jpg,0,0,34,72,3,109
5209744209.jpg,2,15,87,23,0,127
5209757780.jpg,0,11,70,25,0,106
5209944633.jpg,5,62,33,5,0,105
5211888253.jpg,12,73,19,0,0,104
5212354067.jpg,10,59,58,0,0,127
5212639990.jpg,0,3,64,32,0,99
5212871853.jpg,1,12,68,28,0,109
5213032846.jpg,17,83,13,0,0,113
5215794269.jpg,0,2,37,63,1,103
5215856083.jpg,0,3,45,60,1,109
5216419230.jpg,0,1,36,56,5,98
5216478650.jpg,0,1,50,53,0,104
5216870847.jpg,0,14,87,10,0,111
5216894561.jpg,0,4,74,31,0,109
5217550500.jpg,17,64,25,2,0,108
5217753146.jpg,0,6,67,36,0,109
5217952997.jpg,0,1,50,58,1,110
5219241121.jpg,0,1,46,60,4,111
5219276400.jpg,0,10,71,28,0,109
5219524859.jpg,0,38,65,5,0,108
5219577819.jpg,2,29,57,14,0,102
52196600.jpg,1,23,58,23,2,107
5221875216.jpg,0,39,63,7,0,109
5222301193.jpg,7,72,29,3,0,111
5222918882.jpg,0,0,24,79,6,109
5223615087.jpg,0,0,30,69,5,104
5224064761.jpg,0,8,33,60,2,103
5224316825.jpg,13,62,32,1,0,108
5224440098.jpg,3,29,65,10,0,107
5225674723.jpg,0,1,47,51,2,101
5226685642.jpg,2,33,61,8,0,104
522689278.jpg,1,22,66,21,2,112
5227449110.jpg,0,0,30,70,7,107
5227846365.jpg,2,56,46,1,0,105
5228772358.jpg,0,3,57,44,2,106
5229829828.jpg,0,13,75,13,0,101
5230623311.jpg,12,54,30,1,0,97
5230942989.jpg,0,4,68,31,0,103
523099326.jpg,1,8,34,50,9,102
5231173987.jpg,10,72,19,1,0,102
5231773522.jpg,37,52,17,3,0,109
523281293.jpg,0,4,59,40,0,103
5233144595.jpg,0,1,24,68,5,98
5233563523.jpg,0,3,46,52,1,102
5233564371.jpg,1,12,64,33,2,112
5233734612.jpg,0,16,59,27,1,103
5235142622.jpg,0,8,74,18,0,100
5235250770.jpg,0,4,50,50,1,105
5235352004.jpg,0,46,51,6,0,103
5236193983.jpg,0,2,26,77,3,108
5236886996.jpg,0,1,36,65,2,104
5237114997.jpg,6,76,25,0,0,107
5238246589.jpg,0,2,35,61,3,101
5239610533.jpg,6,50,38,5,0,99
5240635967.jpg,0,1,41,59,2,103
5240740919.jpg,1,5,70,29,1,106
5241841036.jpg,0,0,23,84,5,112
5243003019.jpg,0,41,65,0,0,106
5243954323.jpg,1,43,99,10,0,153
524406040.jpg,3,60,37,2,0,102
5245617824.jpg,0,26,60,13,0,99
5247748944.jpg,2,27,61,19,0,109
5248353672.jpg,2,55,42,4,0,103
5248435224.jpg,0,12,72,23,0,107
5248577035.jpg,1,37,61,3,0,102
5249052587.jpg,1,11,77,21,0,110
5250131819.jpg,2,59,44,0,0,105
5250684478.jpg,1,19,63,19,0,102
5250708423.jpg,3,49,46,8,0,106
5251074570.jpg,1,23,51,31,1,107
5251948512.jpg,0,2,72,80,1,155
525227728.jpg,0,1,27,72,8,108
5252606224.jpg,0,9,59,36,1,105
5253482286.jpg,0,4,82,23,0,109
5254421603.jpg,0,3,29,70,5,107
5254718076.jpg,6,36,52,8,0,102
5255413716.jpg,0,9,70,20,0,99
52568944.jpg,14,64,24,1,0,103
5257060848.jpg,7,42,44,9,0,102
5257307362.jpg,0,32,63,6,0,101
5257312652.jpg,0,1,18,80,4,103
5258392332.jpg,0,2,51,45,2,100
5258646457.jpg,0,4,39,54,2,99
526016794.jpg,3,36,60,8,0,107
526020496.jpg,0,13,82,12,0,107
5260460290.jpg,1,21,67,16,0,105
5261084727.jpg,0,2,37,56,3,98
5261188573.jpg,0,0,85,23,0,108
5261364718.jpg,0,3,75,22,0,100
5263912639.jpg,20,72,9,1,0,102
5265556048.jpg,0,0,42,64,4,110
526555735.jpg,1,29,56,16,0,102
5266123407.jpg,0,0,37,70,6,113
5266542779.jpg,0,5,58,37,0,100
5267121563.jpg,0,4,45,59,1,109
526762082.jpg,0,3,51,57,2,113
5269040313.jpg,55,45,5,0,0,105
5269333343.jpg,0,0,22,76,4,102
5270171351.jpg,3,47,50,1,0,101
5270848965.jpg,0,2,52,47,3,104
5271307677.jpg,0,22,89,16,0,127
5272496469.jpg,15,51,37,5,0,108
5274473740.jpg,0,3,37,62,7,109
5274682163.jpg,9,85,16,1,0,111
5275524338.jpg,0,3,32,68,2,105
5276281329.jpg,0,18,72,13,0,103
527633229.jpg,1,20,66,18,0,105
5276579774.jpg,0,10,81,13,0,104
5276700957.jpg,5,42,56,9,0,112
5277411499.jpg,1,61,43,0,0,105
5277615188.jpg,0,0,16,82,4,102
5277655082.jpg,2,26,67,7,0,102
5279252148.jpg,0,26,60,18,0,104
5279579302.jpg,37,66,5,0,0,108
5286251169.jpg,0,4,59,35,2,100
5286481593.jpg,0,1,58,42,3,104
5286800940.jpg,0,8,65,22,2,97
5286915372.jpg,0,1,43,55,6,105
5288273177.jpg,0,8,74,21,1,104
5288290650.jpg,0,0,39,58,4,101
528858440.jpg,9,52,46,6,0,113
5289133619.jpg,0,17,70,10,0,97
528938817.jpg,5,64,52,1,0,122
528982659.jpg,5,43,52,7,0,107
5289896585.jpg,0,1,31,71,2,105
5290105717.jpg,41,61,4,1,0,107
5290554591.jpg,0,5,52,44,2,103
5291504812.jpg,0,7,67,31,1,106
5292219744.jpg,6,77,20,0,0,103
5292802931.jpg,6,48,47,6,0,107
5293191802.jpg,0,3,62,38,1,104
5293214322.jpg,0,1,37,64,6,108
5293957533.jpg,0,6,50,52,2,110
5294012475.jpg,0,1,27,72,4,104
5294769560.jpg,0,2,53,66,1,122
5296875210.jpg,1,4,37,62,3,107
5297588508.jpg,2,13,63,23,0,101
5298103951.jpg,2,39,62,2,0,105
5298580335.jpg,1,27,68,7,0,103
5298734322.jpg,0,3,63,31,0,97
5300293470.jpg,0,14,71,18,0,103
5300926101.jpg,0,8,60,29,1,98
5301312418.jpg,3,24,64,17,0,108
5302119756.jpg,0,1,38,62,1,102
5304364574.jpg,0,6,66,32,0,104
5305142351.jpg,0,5,36,59,8,108
5305438208.jpg,1,39,62,10,0,112
5306390584.jpg,0,5,68,28,2,103
5306558367.jpg,4,53,60,2,1,120
53065971.jpg,19,80,6,1,0,106
5306806108.jpg,0,3,43,61,2,109
5306814937.jpg,0,2,32,72,1,107
5306909990.jpg,68,35,0,0,0,103
5308397567.jpg,0,0,23,75,3,101
5308844734.jpg,0,1,27,73,4,105
5309326426.jpg,0,0,37,64,2,103
5309442831.jpg,0,2,33,68,1,104
5309538408.jpg,0,16,66,25,0,107
5310130081.jpg,0,1,33,68,1,103
5310307882.jpg,0,14,73,13,1,101
5311906994.jpg,0,1,53,49,1,104
5312388504.jpg,0,2,66,59,2,129
5314378959.jpg,20,70,12,2,0,104
531477784.jpg,55,50,2,0,0,107
5314923965.jpg,3,26,57,18,0,104
5314968272.jpg,0,6,61,41,1,109
5315386438.jpg,0,29,74,11,0,114
5316693478.jpg,0,8,72,23,0,103
5317045814.jpg,0,0,49,51,2,102
5318008559.jpg,1,18,67,22,2,110
5318152871.jpg,0,27,64,8,0,99
5318520232.jpg,1,40,54,10,0,105
531889120.jpg,0,3,38,60,5,106
5320165275.jpg,0,1,49,52,1,103
5320512069.jpg,7,36,55,15,0,113
5320573901.jpg,4,81,22,0,0,107
5321706893.jpg,0,9,84,17,0,110
5323028515.jpg,0,30,69,12,0,111
5323106663.jpg,0,20,71,15,1,107
5323234112.jpg,1,19,68,12,0,100
5324909950.jpg,1,3,44,58,2,108
5325140020.jpg,1,26,60,21,1,109
5325398566.jpg,0,10,76,21,0,107
5326008096.jpg,0,5,64,33,2,104
5327737580.jpg,0,14,81,8,0,103
5328075993.jpg,0,2,58,48,1,109
5328147958.jpg,0,40,60,5,0,105
5328853523.jpg,0,9,86,27,0,122
5329486988.jpg,0,1,44,56,3,104
5329734345.jpg,1,8,63,33,0,105
5333075930.jpg,0,2,35,64,1,102
5333965568.jpg,0,1,27,71,4,103
5334294455.jpg,0,2,46,61,0,109
5335866018.jpg,0,7,83,16,1,107
5337216786.jpg,0,3,74,52,0,129
5337507620.jpg,0,10,52,41,2,105
5338193826.jpg,0,16,75,16,0,107
5339188116.jpg,0,1,49,47,5,102
5341341783.jpg,8,72,23,0,0,103
5341393819.jpg,0,3,34,59,6,102
5342778275.jpg,0,16,69,17,0,102
5342791481.jpg,5,64,29,0,0,98
5343739846.jpg,5,34,54,17,0,110
5344616817.jpg,0,4,78,30,1,113
5346690387.jpg,1,20,64,17,0,102
5347056182.jpg,31,69,2,0,0,102
5347293716.jpg,0,3,50,47,0,100
5348237812.jpg,5,55,46,4,0,110
5349969174.jpg,2,65,31,2,0,100
5350540236.jpg,0,1,50,51,2,104
5352670374.jpg,0,4,54,47,1,106
5352866440.jpg,0,0,14,77,15,106
5353332977.jpg,0,57,44,3,0,104
5353881693.jpg,0,17,73,17,0,107
5354068609.jpg,0,8,55,33,1,97
5354173860.jpg,0,4,42,84,0,130
535434144.jpg,0,2,24,74,4,104
5354698.jpg,0,4,18,73,14,109
5354741393.jpg,0,3,77,22,0,102
535787632.jpg,1,48,47,3,0,99
5358352176.jpg,2,48,50,2,0,102
5358640896.jpg,0,2,46,51,2,101
5359127660.jpg,0,3,48,49,1,101
5359274053.jpg,8,84,12,0,0,104
5359786621.jpg,0,3,39,55,2,99
5360175600.jpg,0,0,31,73,6,110
5360940013.jpg,2,63,41,0,0,106
5361947887.jpg,0,2,66,34,2,104
5362095529.jpg,0,2,25,69,6,102
5362140571.jpg,18,74,7,0,0,99
5362664790.jpg,0,3,71,29,2,105
5363058682.jpg,32,70,3,0,0,105
5363150332.jpg,2,19,56,24,1,102
5363442288.jpg,0,2,33,69,2,106
5363486044.jpg,2,10,75,18,0,105
5364140480.jpg,0,7,47,44,2,100
5364427287.jpg,0,0,42,62,2,106
5365003071.jpg,0,2,48,54,4,108
5365082886.jpg,0,2,48,45,0,95
5367389511.jpg,0,19,53,30,2,104
5369434001.jpg,44,56,7,0,0,107
5370538873.jpg,0,23,61,16,0,100
5370637046.jpg,0,2,36,62,1,101
5370690667.jpg,0,3,52,46,3,104
537074410.jpg,6,50,41,4,0,101
5371908851.jpg,0,6,57,39,0,102
537232636.jpg,3,46,52,3,0,104
5375536055.jpg,0,2,51,56,1,110
5376223041.jpg,0,0,44,57,4,105
5376228237.jpg,11,81,33,0,0,125
5377492041.jpg,0,10,68,27,1,106
5378235552.jpg,0,0,60,51,1,112
5378725814.jpg,0,8,83,19,0,110
5378902324.jpg,0,2,51,77,1,131
5379331695.jpg,0,10,67,24,1,102
5380064296.jpg,0,10,83,11,0,104
5382638405.jpg,0,42,54,9,0,105
5382913872.jpg,1,58,44,4,0,107
5384624254.jpg,0,2,55,51,1,109
5384977865.jpg,0,28,64,16,1,109
5385663967.jpg,0,8,42,53,1,104
5385761239.jpg,0,29,60,10,1,100
5386032677.jpg,0,33,69,10,0,112
5387093344.jpg,0,13,60,36,0,109
5391319632.jpg,6,66,34,2,0,108
5393136028.jpg,0,18,72,14,0,104
539361542.jpg,0,0,27,72,5,104
5394502414.jpg,4,36,50,13,0,103
5394508968.jpg,0,6,54,47,0,107
5394548782.jpg,2,33,59,9,1,104
539524376.jpg,4,57,35,5,0,101
5395790450.jpg,7,64,33,0,0,104
5395880951.jpg,0,43,61,4,0,108
5396644364.jpg,0,1,47,79,0,127
5397802120.jpg,0,1,36,56,7,100
5398457925.jpg,1,59,44,3,0,107
5398576953.jpg,0,2,83,61,1,147
5398610144.jpg,0,20,58,27,0,105
5399180378.jpg,2,3,48,49,3,105
5399186343.jpg,0,13,59,34,1,107
5399327452.jpg,0,2,66,30,1,99
5399475116.jpg,0,1,41,63,1,106
5400709579.jpg,0,0,49,56,0,105
5401046644.jpg,2,16,72,19,0,109
540261908.jpg,0,18,69,10,0,97
5402750878.jpg,2,68,29,2,0,101
5402777838.jpg,8,73,22,0,0,103
5403603296.jpg,0,0,35,57,7,99
5404092797.jpg,0,1,41,71,1,114
5406869186.jpg,0,12,73,12,0,97
5407049859.jpg,0,1,38,57,7,103
5407907045.jpg,1,25,62,12,1,101
5407931669.jpg,0,3,39,65,0,107
5408161730.jpg,6,79,23,0,0,108
5408602889.jpg,0,1,37,72,2,112
5409637634.jpg,0,3,39,53,3,98
5409793551.jpg,0,7,66,32,0,105
5409841653.jpg,0,0,50,56,3,109
5409949181.jpg,0,5,41,61,2,109
5411857475.jpg,0,6,71,19,0,96
5412162988.jpg,0,1,34,66,5,106
5413723205.jpg,0,0,27,74,10,111
5414089487.jpg,0,0,27,93,5,125
5414221487.jpg,0,1,33,61,7,102
5414222209.jpg,0,4,24,66,9,103
5416465084.jpg,1,20,99,7,0,127
5416851305.jpg,2,36,66,8,0,112
5417875149.jpg,3,52,47,3,0,105
5418130754.jpg,29,74,6,0,0,109
5419570020.jpg,0,3,60,38,2,103
5419962760.jpg,1,0,41,59,2,103
5420001635.jpg,0,0,19,72,13,104
5420375203.jpg,0,0,40,62,0,102
5421015027.jpg,0,3,64,46,0,113
5421157000.jpg,0,16,80,6,0,102
5421731776.jpg,0,11,83,15,0,109
5422446412.jpg,0,1,27,75,3,106
5422890420.jpg,1,21,72,13,0,107
5423246371.jpg,0,1,50,54,1,106
5423639636.jpg,1,6,83,35,0,125
5423986833.jpg,1,16,78,7,0,102
5424903451.jpg,0,8,39,56,2,105
5426014939.jpg,2,22,57,18,1,100
5426100555.jpg,1,18,57,19,3,98
5427956048.jpg,0,2,59,43,0,104
5430352868.jpg,0,2,40,58,3,103
5430572465.jpg,0,2,43,58,1,104
5431342278.jpg,11,75,16,4,0,106
5432792987.jpg,3,73,25,1,0,102
5433364879.jpg,10,73,25,0,0,108
5433512452.jpg,1,9,53,42,2,107
5434458853.jpg,0,9,46,47,3,105
5434982423.jpg,1,85,49,2,0,137
5435410945.jpg,0,3,28,71,5,107
5436025882.jpg,0,3,51,49,2,105
5436078668.jpg,0,0,16,85,10,111
5436442410.jpg,0,1,49,57,2,109
5437097825.jpg,0,2,52,45,3,102
5437565452.jpg,0,5,59,40,1,105
5437634548.jpg,2,9,60,34,0,105
5438123525.jpg,1,51,49,4,0,105
5438275650.jpg,0,14,90,44,2,150
5438289269.jpg,0,13,72,15,0,100
5441628490.jpg,0,0,24,71,4,99
5442770752.jpg,0,23,67,10,0,100
5443109303.jpg,1,12,65,32,0,110
5443343893.jpg,0,7,61,33,0,101
5443561588.jpg,1,36,60,6,0,103
5443888755.jpg,1,17,56,29,1,104
5444850191.jpg,0,4,53,47,1,105
5445781988.jpg,0,2,37,97,1,137
5445842177.jpg,0,5,55,41,1,102
5446222117.jpg,0,0,39,61,5,105
5446650089.jpg,0,9,58,34,2,103
5447010296.jpg,0,11,73,15,0,99
5447287552.jpg,0,1,44,50,1,96
5447567442.jpg,0,4,51,51,3,109
5447858710.jpg,0,1,62,43,0,106
5448376373.jpg,0,0,15,77,11,103
5449529114.jpg,1,2,33,67,8,111
545103098.jpg,73,32,1,0,0,106
5451071783.jpg,0,4,70,28,0,102
5451526397.jpg,0,4,57,44,1,106
5453819984.jpg,0,1,59,47,2,109
5453875819.jpg,0,4,78,46,0,128
5454031554.jpg,0,0,21,76,4,101
5454884110.jpg,0,0,18,81,6,105
5454942480.jpg,0,1,71,35,0,107
5455599246.jpg,1,5,81,21,0,108
5456329601.jpg,1,9,57,37,3,107
5456373866.jpg,11,54,39,3,0,107
5457535055.jpg,0,3,63,41,0,107
5458340790.jpg,1,9,63,29,1,103
5458771275.jpg,0,5,74,28,1,108
5459231907.jpg,0,2,33,67,2,104
5459372516.jpg,0,4,65,61,1,131
5459749774.jpg,0,29,94,7,0,130
5460394455.jpg,0,1,25,78,3,107
5461710344.jpg,0,16,83,7,0,106
5462153314.jpg,0,2,34,66,5,107
5462654627.jpg,1,0,22,80,4,107
5463672195.jpg,0,9,72,23,1,105
5463929157.jpg,5,44,55,2,0,106
5464134286.jpg,0,13,65,23,1,102
5464519026.jpg,2,28,56,18,0,104
5465127384.jpg,0,8,59,36,2,105
5466371904.jpg,0,0,10,67,30,107
5467862729.jpg,0,1,29,71,7,108
5468320493.jpg,0,1,49,54,0,104
5468530650.jpg,0,1,51,54,0,106
5468577486.jpg,1,40,49,10,0,100
5468605223.jpg,0,14,51,41,1,107
5468768534.jpg,0,3,41,58,1,103
5469380265.jpg,2,9,68,27,0,106
5470588240.jpg,0,0,27,72,6,105
5471871046.jpg,5,66,37,2,0,110
5473035889.jpg,0,2,34,71,4,111
5474201544.jpg,1,3,59,41,2,106
5474715935.jpg,0,4,51,45,2,102
5476657075.jpg,0,2,57,42,0,101
5477401446.jpg,0,20,64,20,0,104
5478338784.jpg,0,2,44,53,3,102
5478338919.jpg,0,1,31,76,2,110
5478757587.jpg,0,0,45,54,0,99
5479353117.jpg,0,17,67,18,0,102
5479751565.jpg,0,0,54,45,1,100
5480071347.jpg,0,2,38,68,0,108
5480462577.jpg,0,25,71,7,0,103
5480500661.jpg,2,10,79,15,0,106
5480545191.jpg,15,67,30,0,0,112
5480693901.jpg,0,1,41,71,6,119
5480778835.jpg,0,20,57,28,3,108
5480952207.jpg,0,20,66,17,1,104
5481249377.jpg,1,71,35,3,0,110
5482033930.jpg,0,2,48,53,1,104
5482786130.jpg,0,0,31,69,8,108
5483050895.jpg,0,1,48,51,1,101
5483224233.jpg,0,4,68,26,0,98
5483273817.jpg,0,14,69,19,0,102
5483514140.jpg,0,0,28,76,8,112
5483567910.jpg,0,2,46,59,0,107
5483697378.jpg,0,28,61,17,0,106
5483904990.jpg,1,18,74,15,0,108
5484179033.jpg,0,2,57,41,2,102
5484776927.jpg,0,2,29,72,4,107
5485090581.jpg,2,47,51,4,0,104
5485536219.jpg,1,55,67,5,1,129
5485752257.jpg,0,0,22,77,5,104
5487306011.jpg,0,10,96,22,0,128
5487766524.jpg,1,26,64,16,0,107
5487845072.jpg,0,39,61,4,0,104
5489335291.jpg,0,0,31,69,9,109
5489747456.jpg,1,15,81,8,0,105
5490633123.jpg,0,5,81,24,0,110
5491791732.jpg,0,0,16,88,7,111
5492807512.jpg,0,7,65,35,0,107
5492904052.jpg,4,34,44,18,0,100
5493295509.jpg,0,1,47,54,5,107
5494503911.jpg,0,1,30,61,9,101
5494614015.jpg,0,6,60,40,0,106
5494859211.jpg,5,80,15,1,0,101
549547230.jpg,0,24,72,7,0,103
5495551820.jpg,0,34,64,6,0,104
5495773051.jpg,0,10,65,31,0,106
5496213154.jpg,0,1,28,67,3,99
5496219084.jpg,0,0,18,75,6,99
5498003598.jpg,0,3,52,46,0,101
5498162547.jpg,0,27,61,19,0,107
5498204974.jpg,7,65,27,2,0,101
5500159889.jpg,14,43,42,4,0,103
5500570132.jpg,0,5,69,27,1,102
5501090896.jpg,0,2,74,30,0,106
5502038719.jpg,0,3,58,40,1,102
5502130313.jpg,0,20,70,15,1,106
5503696409.jpg,1,15,69,17,0,102
5503983536.jpg,0,4,56,50,1,111
5504474324.jpg,0,15,76,10,0,101
5505340753.jpg,0,41,62,6,0,109
5505953336.jpg,36,67,8,0,0,111
5506212777.jpg,0,12,89,39,0,140
5506716444.jpg,0,9,59,39,1,108
5507113852.jpg,0,6,88,54,0,148
5507499346.jpg,17,80,15,1,0,113
5508053398.jpg,0,0,39,71,1,111
5508282751.jpg,0,2,26,76,4,108
5508551413.jpg,9,76,15,0,0,100
5511460602.jpg,1,33,64,7,0,105
5511925995.jpg,0,1,28,72,8,109
5512214624.jpg,5,55,38,1,0,99
5512989538.jpg,0,2,45,64,3,114
5513320745.jpg,0,2,57,41,2,102
5513852883.jpg,0,3,65,36,0,104
5513962677.jpg,0,3,53,46,3,105
5514669907.jpg,0,0,27,75,6,108
5514988242.jpg,0,8,77,44,0,129
5517184431.jpg,0,4,61,44,2,111
5517232825.jpg,0,3,50,55,3,111
5517472829.jpg,0,1,25,80,5,111
5519011400.jpg,0,20,75,18,0,113
5519858461.jpg,0,4,63,64,1,132
5519904752.jpg,3,67,36,2,0,108
5520092588.jpg,0,26,70,10,0,106
5522198347.jpg,1,44,56,9,0,110
5524014245.jpg,0,9,67,34,0,110
5525531268.jpg,1,34,69,9,0,113
5525979481.jpg,0,35,69,3,0,107
552629141.jpg,10,72,24,1,0,107
5526408007.jpg,0,10,77,18,0,105
5527632049.jpg,0,4,52,71,2,129
5527745877.jpg,0,0,11,78,23,112
5527892107.jpg,0,1,63,38,2,104
5528731780.jpg,0,2,48,57,1,108
5529240672.jpg,0,4,74,24,2,104
5529298204.jpg,0,5,53,52,2,112
5529999885.jpg,0,6,69,31,0,106
5530039463.jpg,0,25,75,10,0,110
5530579735.jpg,1,54,58,2,0,115
5531191792.jpg,5,46,55,2,0,108
5531274580.jpg,0,2,43,56,0,101
5532612839.jpg,0,6,70,27,0,103
5533176494.jpg,0,42,54,4,0,100
5533236075.jpg,0,3,50,51,3,107
5533853499.jpg,0,8,83,36,0,127
5534328979.jpg,1,30,61,14,0,106
5534680063.jpg,0,0,43,50,2,95
5535054309.jpg,1,69,39,1,0,110
5535937496.jpg,1,20,75,6,0,102
5536150022.jpg,25,66,11,0,0,102
5536240490.jpg,1,27,67,9,0,104
5536386046.jpg,0,3,31,66,6,106
5536798233.jpg,0,4,66,30,1,101
5536900966.jpg,0,1,27,73,6,107
5537272633.jpg,4,68,34,0,0,106
5537911913.jpg,0,6,67,65,1,139
5538586634.jpg,0,0,22,75,10,107
5538859369.jpg,0,3,49,50,2,104
5539522093.jpg,0,3,43,51,0,97
5540094499.jpg,0,3,44,54,1,102
5540702638.jpg,0,1,37,67,0,105
5541438392.jpg,5,36,49,16,0,106
5542509126.jpg,0,0,35,67,5,107
5543037671.jpg,0,6,63,32,1,102
5543296873.jpg,0,5,37,58,3,103
5543308408.jpg,0,0,21,81,4,106
5544109408.jpg,0,10,96,25,0,131
5544820783.jpg,0,46,59,3,0,108
5545551375.jpg,0,2,69,32,0,103
5546833927.jpg,1,10,91,36,1,139
5546979604.jpg,0,1,45,58,2,106
5547599151.jpg,1,50,49,5,0,105
5550230387.jpg,0,6,98,35,1,140
5551470289.jpg,0,9,78,19,0,106
5552453199.jpg,0,0,72,37,0,109
5552904756.jpg,0,2,43,62,3,110
5553150523.jpg,2,14,73,14,0,103
5554016525.jpg,0,1,16,82,8,107
5554413140.jpg,1,0,32,67,7,107
5554551412.jpg,8,70,28,1,1,108
5554808879.jpg,0,0,23,75,8,106
5557351990.jpg,4,54,44,5,0,107
5557571977.jpg,0,33,67,10,0,110
5558342101.jpg,1,6,56,39,2,104
5559771526.jpg,0,17,69,20,0,106
5560114332.jpg,6,41,40,12,3,102
5561303733.jpg,8,56,41,0,0,105
5561541116.jpg,2,35,63,8,0,108
5561556380.jpg,0,9,65,34,0,108
5561903765.jpg,0,13,76,22,0,111
5562631980.jpg,0,0,35,68,3,106
5562990409.jpg,0,0,37,68,1,106
5563391138.jpg,1,32,56,11,0,100
5564289750.jpg,0,0,20,85,4,109
5564570846.jpg,0,1,40,58,1,100
5564762599.jpg,0,0,21,82,5,108
5564925519.jpg,9,51,40,3,0,103
5565514955.jpg,1,33,53,13,1,101
5565922078.jpg,0,4,63,59,0,126
5566203819.jpg,0,56,41,4,0,101
556649487.jpg,0,10,70,24,1,105
5568534829.jpg,0,9,62,26,0,97
5569285371.jpg,0,0,47,61,2,110
5569562301.jpg,9,45,43,7,0,104
5569876905.jpg,0,34,62,11,0,107
5570837854.jpg,0,15,72,17,0,104
5571612935.jpg,0,1,67,39,0,107
5571768533.jpg,1,19,70,23,0,113
5571835679.jpg,7,66,36,1,0,110
5572325411.jpg,0,3,31,75,4,113
5572898913.jpg,26,68,12,0,0,106
5573315618.jpg,1,37,60,10,0,108
5573453953.jpg,1,19,63,22,0,105
5573505825.jpg,0,0,36,66,4,106
5573708083.jpg,1,12,70,22,0,105
5574048372.jpg,0,3,59,41,3,106
5575057872.jpg,0,10,72,21,0,103
5575661562.jpg,0,0,19,71,8,98
5577238906.jpg,0,0,32,75,3,110
5577299644.jpg,0,23,72,18,1,114
5577977748.jpg,7,93,10,0,0,110
5578143578.jpg,0,1,55,84,2,142
5580400310.jpg,1,11,71,25,0,108
5580904626.jpg,0,0,29,68,1,98
5581852297.jpg,5,82,16,4,0,107
5583866722.jpg,1,49,50,2,0,102
5585956743.jpg,0,6,54,40,0,100
5586376319.jpg,1,10,61,29,2,103
5586890749.jpg,0,3,43,52,2,100
558820165.jpg,0,6,64,40,2,112
5588234773.jpg,21,65,17,2,0,105
5588363134.jpg,1,7,62,36,0,106
5588569639.jpg,0,0,37,62,4,103
5588623277.jpg,1,1,32,65,4,103
5588665887.jpg,1,2,55,75,2,135
5589406824.jpg,1,45,53,1,0,100
5590179803.jpg,0,12,61,28,0,101
5590319772.jpg,1,50,45,5,0,101
5592031827.jpg,1,11,71,13,0,96
5592040758.jpg,0,3,43,65,2,113
5592471041.jpg,0,1,67,38,1,107
5592815589.jpg,0,4,74,21,1,100
5593028853.jpg,0,9,60,33,1,103
5593982816.jpg,0,6,53,41,0,100
5594109805.jpg,0,2,38,61,3,104
5594332636.jpg,0,1,40,59,1,101
5594349841.jpg,0,2,41,61,1,105
5594639206.jpg,0,7,61,34,0,102
5594665184.jpg,0,6,50,47,2,105
5596136215.jpg,1,13,64,35,0,113
5596270310.jpg,0,9,65,30,1,105
5597029310.jpg,2,38,55,5,0,100
5597221402.jpg,0,10,72,26,0,108
5597328203.jpg,0,34,61,13,0,108
5598111719.jpg,0,9,62,25,1,97
5599500585.jpg,0,18,64,21,0,103
5599655175.jpg,0,2,32,59,13,106
5599685670.jpg,0,6,57,39,2,104
560054684.jpg,26,64,11,0,0,101
5601711871.jpg,0,0,33,74,4,111
5602088551.jpg,0,2,57,50,2,111
5602195949.jpg,0,1,48,59,2,110
5602472061.jpg,0,6,60,37,1,104
5602672763.jpg,0,7,60,37,4,108
5602815566.jpg,0,7,51,37,5,100
5604745238.jpg,9,98,20,0,0,127
5605845677.jpg,3,30,70,5,0,108
5606263347.jpg,23,77,6,0,0,106
5606634799.jpg,0,1,56,43,1,101
5606693622.jpg,1,11,58,44,0,114
5607542951.jpg,0,30,70,7,0,107
5609386026.jpg,2,21,52,29,0,104
5610005411.jpg,0,0,47,59,1,107
5611311337.jpg,10,68,24,3,0,105
5611315745.jpg,1,49,52,4,0,106
561215186.jpg,0,1,66,40,0,107
5612537234.jpg,0,1,33,65,6,105
5613119527.jpg,0,46,54,5,1,106
5613166397.jpg,2,59,44,2,0,107
5615226673.jpg,9,71,20,4,0,104
5616548747.jpg,0,3,20,77,2,102
5617741019.jpg,0,0,40,62,1,103
5617865491.jpg,0,18,70,15,0,103
5619348479.jpg,3,52,47,5,0,107
5619807447.jpg,0,5,47,46,4,102
5621762674.jpg,0,1,15,76,13,105
5621947330.jpg,0,1,54,79,0,134
5622280405.jpg,2,67,37,2,0,108
5622618497.jpg,0,1,35,69,2,107
5623266706.jpg,0,0,47,53,1,101
5625316207.jpg,0,2,87,39,1,129
5625825104.jpg,0,3,55,44,3,105
5626243539.jpg,6,33,54,12,0,105
5627315065.jpg,0,0,26,83,2,111
56278886.jpg,3,39,54,6,0,102
5627914510.jpg,0,1,58,40,6,105
5628057241.jpg,0,5,47,56,0,108
5628498882.jpg,0,2,40,58,2,102
5628676220.jpg,0,2,34,69,1,106
5628766419.jpg,1,30,60,8,0,99
5628885328.jpg,0,3,50,49,0,102
5629171325.jpg,1,12,42,51,2,108
562942809.jpg,42,70,14,1,0,127
5630657407.jpg,0,3,51,50,3,107
5630751358.jpg,0,0,19,88,7,114
5631242230.jpg,1,8,57,41,0,107
5631644954.jpg,2,30,73,8,0,113
5631740117.jpg,0,1,16,73,8,98
5632060967.jpg,0,0,68,39,1,108
5633412794.jpg,0,3,37,57,4,101
563363297.jpg,1,42,65,4,0,112
5634507491.jpg,2,28,54,19,0,103
5634844318.jpg,0,39,63,2,0,104
563494328.jpg,18,80,11,0,0,109
5635139040.jpg,0,3,64,65,0,132
5636641388.jpg,0,10,62,34,3,109
5637731734.jpg,0,0,34,72,5,111
5642132751.jpg,0,20,64,20,0,104
5642698379.jpg,0,39,70,3,0,112
5643675511.jpg,42,58,7,1,0,108
5643887824.jpg,0,4,50,44,6,104
5643888483.jpg,1,22,57,26,0,106
5644548369.jpg,0,1,18,84,6,109
5644640425.jpg,0,4,42,53,1,100
5644717504.jpg,1,31,70,7,0,109
5645210616.jpg,0,1,26,67,1,95
5645276165.jpg,0,6,50,46,3,105
5645356042.jpg,0,4,39,57,2,102
5645503965.jpg,0,17,71,14,0,102
5645568177.jpg,2,16,65,21,1,105
5645669819.jpg,0,19,69,18,0,106
5645990670.jpg,0,32,63,5,0,100
5646094610.jpg,1,12,61,25,0,99
5646137718.jpg,0,44,58,11,0,113
5646738672.jpg,0,6,60,39,0,105
5647215115.jpg,0,4,52,41,0,97
5647243489.jpg,1,9,68,23,0,101
564783596.jpg,0,2,47,55,2,106
5648003529.jpg,0,0,26,77,3,106
5649238461.jpg,3,29,61,10,0,103
5650073370.jpg,0,2,27,58,17,104
5650628470.jpg,1,10,80,20,0,111
5651165439.jpg,0,2,21,82,1,106
5651460875.jpg,0,0,45,60,1,106
5651646348.jpg,0,3,49,52,0,104
5652034742.jpg,0,5,62,34,0,101
5652671086.jpg,4,56,40,0,0,100
5655651548.jpg,6,80,27,0,0,113
5656494008.jpg,0,2,36,66,1,105
5656752407.jpg,0,0,24,80,2,106
5657214180.jpg,0,2,40,86,2,130
5657622409.jpg,0,4,52,47,1,104
5657790806.jpg,0,12,73,27,1,113
5657799294.jpg,7,64,31,5,0,107
5658520618.jpg,1,2,82,22,0,107
5659520017.jpg,0,21,70,12,0,103
5660004991.jpg,8,45,45,9,0,107
5660186741.jpg,2,66,44,1,0,113
5660281772.jpg,34,61,6,0,0,101
5661464368.jpg,0,0,18,74,11,103
5663852709.jpg,0,17,77,10,1,105
5664036497.jpg,0,1,32,64,7,104
5664282389.jpg,0,3,52,48,4,107
5664632199.jpg,1,15,64,28,0,108
5665181716.jpg,0,6,55,66,3,130
5665436785.jpg,0,0,44,60,1,105
5666081630.jpg,0,3,45,58,4,110
5666479112.jpg,0,1,63,46,0,110
5667464271.jpg,0,0,30,75,0,105
5667961686.jpg,0,1,36,99,2,138
5669528587.jpg,1,4,60,38,0,103
5669648365.jpg,0,5,71,21,1,98
5670774641.jpg,0,1,46,55,0,102
5670925520.jpg,0,0,28,71,6,105
5671199285.jpg,8,58,36,3,0,105
5671296107.jpg,0,19,67,19,0,105
5671373340.jpg,0,1,58,48,0,107
5671581323.jpg,0,1,33,69,0,103
5673447503.jpg,0,4,70,26,0,100
5673514295.jpg,0,0,47,59,3,109
5674214513.jpg,0,2,27,81,0,110
5674445474.jpg,0,2,57,44,0,103
5676561526.jpg,0,21,53,39,0,113
5677087869.jpg,0,0,24,74,2,100
5677116051.jpg,0,6,28,66,9,109
5678053727.jpg,0,6,56,46,0,108
5678174838.jpg,0,4,69,33,0,106
5679411319.jpg,0,3,41,61,3,108
5679420644.jpg,0,2,41,64,2,109
5679431462.jpg,0,1,31,70,6,108
5680237187.jpg,0,0,16,82,6,104
5680314396.jpg,0,35,65,8,0,108
5680571645.jpg,11,66,26,0,0,103
5680623261.jpg,0,1,63,43,0,107
5681154520.jpg,0,3,54,46,1,104
5681342957.jpg,0,1,32,66,3,102
5681482199.jpg,0,11,65,31,0,107
5681785926.jpg,0,5,58,35,1,99
5681801478.jpg,1,34,66,8,0,109
5682574149.jpg,1,20,70,8,0,99
5682778748.jpg,2,37,58,5,0,102
5683735781.jpg,0,7,74,25,0,106
5683736894.jpg,6,83,20,3,0,112
5684082265.jpg,0,4,44,52,5,105
5684508410.jpg,0,0,14,89,8,111
5684894057.jpg,0,8,67,24,1,100
5684960466.jpg,22,61,20,1,0,104
5685134916.jpg,0,3,65,30,2,100
5685822958.jpg,0,0,15,77,12,104
5685877023.jpg,0,25,64,16,0,105
5687490427.jpg,0,46,63,3,0,112
5689072971.jpg,0,29,65,4,0,98
5690703973.jpg,2,41,58,4,0,105
5690945868.jpg,0,0,32,72,4,108
5690961665.jpg,0,0,23,72,5,100
5691962850.jpg,0,0,18,91,3,112
5692339429.jpg,0,0,37,64,4,105
5692807668.jpg,2,51,50,2,0,105
5692933688.jpg,0,2,31,65,6,104
5692969991.jpg,0,1,31,70,2,104
5693602630.jpg,0,37,54,8,1,100
5694228883.jpg,0,0,39,65,2,106
5695511111.jpg,0,1,56,52,0,109
5698690184.jpg,0,4,51,46,0,101
5699749992.jpg,0,5,48,52,0,105
5699762014.jpg,0,2,49,52,0,103
5700146083.jpg,0,3,33,55,9,100
5700224418.jpg,2,35,41,26,2,106
5700592133.jpg,0,0,34,69,2,105
5700803236.jpg,0,2,54,46,0,102
5701016184.jpg,3,34,58,15,0,110
5701314350.jpg,0,1,29,70,4,104
570171486.jpg,0,8,49,45,5,107
5702257196.jpg,1,26,88,11,0,126
5705716016.jpg,2,61,41,4,0,108
5706720351.jpg,5,84,19,2,0,110
5706891854.jpg,0,3,51,49,1,104
5707035849.jpg,0,5,64,45,1,115
5707149624.jpg,0,0,38,91,0,129
5707373155.jpg,0,24,66,20,0,110
5707521864.jpg,0,6,52,43,4,105
5708496664.jpg,0,7,69,35,0,111
5709659001.jpg,28,68,8,0,0,104
5711022887.jpg,0,3,68,35,0,106
5712901839.jpg,1,30,59,12,0,102
5713375255.jpg,6,58,33,3,0,100
5714331882.jpg,0,5,68,27,3,103
5715854575.jpg,1,31,72,6,0,110
5716274912.jpg,0,3,51,44,1,99
5717976598.jpg,4,55,48,3,0,110
5718858871.jpg,0,3,48,48,0,99
5719070301.jpg,5,54,49,1,0,109
5719459427.jpg,0,4,36,69,1,110
5719653094.jpg,43,59,6,0,0,108
5720139957.jpg,0,17,66,19,0,102
5720446079.jpg,1,40,74,5,0,120
5723599109.jpg,0,16,81,12,0,109
5724255636.jpg,2,37,65,4,0,108
5724656586.jpg,0,5,51,52,3,111
5725492383.jpg,0,4,80,42,1,127
5726241150.jpg,0,0,22,77,6,105
5726507119.jpg,2,49,45,11,0,107
5727031782.jpg,0,5,49,51,0,105
5727760730.jpg,0,11,65,32,0,108
5727908818.jpg,0,14,80,11,0,105
5730689688.jpg,0,1,34,66,5,106
5731936449.jpg,0,6,53,46,3,108
5732196042.jpg,0,3,41,60,3,107
5732256845.jpg,2,64,34,1,0,101
5734064610.jpg,1,23,66,10,0,100
5734560437.jpg,1,16,70,23,2,112
5734758076.jpg,0,2,54,46,0,102
5737344773.jpg,0,0,54,54,2,110
5737901450.jpg,0,1,14,89,7,111
5739537678.jpg,0,28,69,9,0,106
5740000928.jpg,0,0,50,58,1,109
5740846112.jpg,0,18,68,17,1,104
5741757504.jpg,0,17,71,17,0,105
5741853020.jpg,0,0,15,84,9,108
5743028880.jpg,3,6,56,37,1,103
5745624995.jpg,1,10,79,15,0,105
5746249801.jpg,0,2,47,56,1,106
5746784745.jpg,1,39,82,3,0,125
5747013682.jpg,9,78,14,0,0,101
5748221179.jpg,0,6,73,24,0,103
5748620149.jpg,0,10,81,15,0,106
5748824865.jpg,1,47,57,2,0,107
5748929912.jpg,2,37,62,5,0,106
5748977191.jpg,0,11,72,28,0,111
57501165.jpg,1,26,59,18,2,106
5750644508.jpg,0,8,65,31,0,104
5751931658.jpg,1,27,62,12,0,102
5752124692.jpg,0,1,27,72,1,101
5752256334.jpg,0,12,76,16,0,104
5756343761.jpg,0,1,30,74,5,110
5756631011.jpg,0,7,76,23,0,106
5756854423.jpg,6,32,62,6,0,106
5759402144.jpg,0,0,23,74,0,97
5761420767.jpg,0,20,98,20,0,138
5761873238.jpg,2,40,58,6,0,106
5762320263.jpg,1,67,39,0,0,107
5763062464.jpg,0,1,38,66,2,107
5763573511.jpg,2,43,56,8,0,109
5764115414.jpg,0,1,40,62,5,108
5764514076.jpg,19,95,36,2,0,152
5765377670.jpg,0,0,42,64,3,109
5765859594.jpg,0,0,29,75,1,105
5766806996.jpg,21,80,10,0,0,111
5768167934.jpg,0,1,13,70,29,113
5770080490.jpg,0,2,59,47,1,109
5771711136.jpg,0,4,71,27,1,103
5771887382.jpg,9,92,8,0,0,109
5773170451.jpg,0,5,57,38,1,101
5773721595.jpg,0,14,70,18,0,102
5775598450.jpg,0,0,21,68,15,104
5777168643.jpg,0,0,54,57,0,111
5777912776.jpg,0,1,36,64,1,102
5780359774.jpg,0,0,46,54,3,103
5780360656.jpg,0,1,28,73,1,103
5782679543.jpg,0,9,67,27,1,104
5782924074.jpg,0,1,32,71,6,110
5782928744.jpg,0,7,64,36,1,108
5783124720.jpg,3,78,21,2,0,104
5784134624.jpg,2,48,53,6,0,109
5784673341.jpg,0,7,48,54,1,110
5785719824.jpg,10,74,19,0,0,103
5786083032.jpg,0,20,59,26,1,106
5786468844.jpg,0,5,35,57,6,103
5786557550.jpg,0,2,68,38,1,109
5788614098.jpg,0,11,68,27,0,106
5788815207.jpg,0,2,47,48,1,98
5789601551.jpg,1,21,69,18,0,109
5790219836.jpg,0,9,65,31,1,106
5791107273.jpg,0,23,57,21,0,101
5791949308.jpg,4,80,21,0,0,105
5793101915.jpg,0,2,29,72,10,113
5794649659.jpg,0,13,46,39,2,100
5794758875.jpg,1,17,62,17,1,98
5795183898.jpg,0,1,55,50,1,107
5796436033.jpg,0,8,56,42,1,107
5796747370.jpg,0,1,37,65,2,105
5796923587.jpg,0,2,51,41,1,95
5797735856.jpg,1,43,52,12,0,108
5798200461.jpg,0,0,41,59,5,105
5798775388.jpg,2,28,68,8,0,106
5799422140.jpg,1,33,67,4,0,105
5802112389.jpg,0,2,52,52,1,107
5802569891.jpg,0,18,71,17,0,106
5803562101.jpg,0,3,54,41,0,98
5803914327.jpg,0,46,60,4,0,110
5804026649.jpg,0,0,21,77,9,107
5804325450.jpg,0,14,56,35,1,106
5804399322.jpg,0,0,34,65,4,103
5805622077.jpg,0,11,59,32,0,102
5805954950.jpg,0,0,42,61,3,106
5807050277.jpg,0,16,68,17,0,101
5807238153.jpg,0,8,75,24,0,107
5807318968.jpg,0,21,77,10,0,108
5808715060.jpg,0,8,70,26,1,105
5809947698.jpg,62,39,5,0,0,106
5812785774.jpg,0,0,28,71,6,105
5812840397.jpg,0,0,45,65,2,112
5813122725.jpg,0,1,51,58,0,110
5813266787.jpg,1,43,54,7,0,105
5815446993.jpg,0,5,68,33,0,106
5817880168.jpg,0,3,52,45,3,103
5819286075.jpg,0,0,27,70,5,102
5820186062.jpg,0,14,76,16,0,106
5821113845.jpg,0,4,45,51,3,103
582148952.jpg,1,2,28,68,2,101
5821971629.jpg,1,34,57,6,0,98
5822039641.jpg,0,2,41,83,6,132
5822093825.jpg,0,1,14,76,16,107
5822768427.jpg,0,3,46,57,2,108
5824082232.jpg,2,43,85,9,1,140
5825243642.jpg,61,39,5,0,0,105
5825508500.jpg,34,61,8,2,0,105
5825939601.jpg,0,0,27,73,6,106
5827032065.jpg,0,46,85,1,0,132
5827460813.jpg,0,8,74,26,0,108
5828251146.jpg,0,15,59,21,1,96
5828254727.jpg,0,18,71,19,0,108
5829241861.jpg,0,17,74,7,0,98
5829966131.jpg,14,66,22,1,0,103
5830228003.jpg,1,3,62,36,0,102
5830956184.jpg,0,5,57,50,0,112
5831302222.jpg,1,46,58,7,0,112
5831366691.jpg,0,8,71,28,1,108
5832751066.jpg,0,0,29,77,2,108
5833229623.jpg,0,8,57,42,1,108
5834781945.jpg,2,1,46,57,1,107
5835525141.jpg,0,1,41,55,2,99
5836498446.jpg,0,3,53,54,1,111
5837969940.jpg,0,3,37,58,6,104
5838329706.jpg,0,8,65,28,1,102
5838518725.jpg,0,4,52,47,2,105
5838794545.jpg,1,6,66,26,2,101
5839623776.jpg,0,17,67,18,1,103
5839793009.jpg,0,4,78,43,1,126
5842574442.jpg,0,1,27,62,13,103
5842712003.jpg,0,1,41,65,2,109
5842931891.jpg,0,0,45,55,1,101
5844622887.jpg,0,4,49,57,0,110
5844813103.jpg,1,50,53,1,0,105
5844921100.jpg,0,3,41,55,6,105
58449294.jpg,1,28,66,14,0,109
5846011911.jpg,1,65,40,0,0,106
5846078806.jpg,0,1,14,82,7,104
5847384440.jpg,0,1,79,67,1,148
5847408057.jpg,0,0,24,78,3,105
5847946773.jpg,6,40,50,10,0,106
5848411050.jpg,0,1,25,65,13,104
5849166675.jpg,1,42,52,4,0,99
5849249346.jpg,0,1,21,76,7,105
5849271016.jpg,0,0,44,75,4,123
5849666747.jpg,0,3,37,62,3,105
5850096725.jpg,3,57,37,3,0,100
5853259008.jpg,0,4,43,59,1,107
5854130158.jpg,0,12,66,23,2,103
5856115357.jpg,1,17,77,11,0,106
5856265647.jpg,0,1,29,73,2,105
5858971250.jpg,0,4,50,47,6,107
5859309993.jpg,0,1,49,68,1,119
5863209284.jpg,0,1,63,47,1,112
5864167034.jpg,1,40,57,7,0,105
5864866052.jpg,1,19,69,12,0,101
5865132229.jpg,0,10,65,32,0,107
5866448510.jpg,0,0,55,55,2,112
5866763424.jpg,0,2,53,68,2,125
5867990992.jpg,3,52,46,5,1,107
5868900850.jpg,0,0,13,77,13,103
5869276624.jpg,0,13,67,19,0,99
5869585652.jpg,0,0,8,64,33,105
5869591890.jpg,0,1,45,62,1,109
5870845920.jpg,0,1,49,58,0,108
5870955720.jpg,0,0,29,67,6,102
5871068150.jpg,0,3,66,40,0,109
5871213191.jpg,0,2,26,78,8,114
5871593028.jpg,0,7,55,37,0,99
5871779223.jpg,2,33,83,10,0,128
5873610214.jpg,0,22,66,17,0,105
5875925963.jpg,0,13,93,13,0,119
5876051594.jpg,0,2,43,53,1,99
5876597412.jpg,0,13,77,21,0,111
5876691783.jpg,0,0,25,69,10,104
5876722447.jpg,0,5,65,26,0,96
5877192304.jpg,0,9,73,24,0,106
5877272501.jpg,0,0,19,83,4,106
5879690252.jpg,0,4,62,35,3,104
5879706162.jpg,0,0,42,60,4,106
5880149356.jpg,1,22,66,18,1,108
5880272825.jpg,0,2,39,73,2,116
5880662445.jpg,37,63,2,0,0,102
5881048001.jpg,0,5,63,44,0,112
5881856929.jpg,0,22,60,24,0,106
5884343005.jpg,0,0,34,63,7,104
5884382109.jpg,0,4,73,33,0,110
5884690824.jpg,0,3,57,44,0,104
5884745280.jpg,3,38,55,6,0,102
5884906716.jpg,0,2,32,74,1,109
5885686436.jpg,0,1,43,65,1,110
5886060405.jpg,0,1,45,53,2,101
5886086971.jpg,0,38,58,6,0,102
5886709832.jpg,1,3,37,63,2,106
5887130142.jpg,9,77,18,0,0,104
5887175840.jpg,10,57,37,1,0,105
5887936508.jpg,0,4,49,56,0,109
5888106239.jpg,0,1,40,65,0,106
5889219072.jpg,0,1,53,46,2,102
5890294263.jpg,0,6,64,35,1,106
5890423400.jpg,0,5,49,51,2,107
5890641011.jpg,0,7,64,37,0,108
5890838382.jpg,1,5,56,41,0,103
5891304676.jpg,1,20,81,13,0,115
5891409099.jpg,0,2,60,42,1,105
5891437045.jpg,0,4,72,28,1,105
5891588921.jpg,0,0,29,77,5,111
5892461244.jpg,0,0,29,73,10,112
5893291303.jpg,0,4,54,47,0,105
5893652818.jpg,37,60,9,0,0,106
5894107324.jpg,0,7,51,52,0,110
5894875244.jpg,0,0,32,66,1,99
5895424608.jpg,0,47,55,6,1,109
5895477446.jpg,0,0,24,73,6,103
5896106502.jpg,0,1,37,66,9,113
5897145842.jpg,8,87,13,0,0,108
5897660924.jpg,0,18,69,19,0,106
5898928772.jpg,0,16,74,14,0,104
5899300375.jpg,1,57,38,6,0,102
5899684696.jpg,1,42,53,4,0,100
5900853532.jpg,1,22,68,11,1,103
5901488995.jpg,3,61,62,2,0,128
5901783769.jpg,0,6,50,48,1,105
590233260.jpg,0,3,68,36,0,107
5902359095.jpg,0,3,51,52,4,110
5903525428.jpg,0,3,45,56,0,104
5903878980.jpg,0,6,47,43,3,99
5903930781.jpg,0,8,31,64,2,105
5904145977.jpg,0,1,28,69,2,100
5904148188.jpg,0,24,94,16,0,134
5904230612.jpg,0,3,42,56,6,107
5905146921.jpg,0,15,73,12,0,100
5905277829.jpg,1,9,85,20,0,115
5906203942.jpg,0,20,74,15,0,109
5906327236.jpg,0,1,51,60,0,112
5906517609.jpg,0,0,44,64,0,108
5906582267.jpg,0,1,44,60,2,107
5906624117.jpg,0,3,46,43,4,96
5906952351.jpg,0,0,22,74,11,107
5907004909.jpg,42,55,7,0,0,104
5908187685.jpg,0,36,97,7,0,140
5909804133.jpg,0,26,67,12,0,105
5909836930.jpg,0,57,50,2,0,109
5910545670.jpg,10,68,22,1,0,101
5910732650.jpg,17,66,14,1,0,98
5912070942.jpg,0,2,54,46,2,104
5912436872.jpg,0,5,54,43,1,103
5912451823.jpg,0,3,49,51,4,107
5912584970.jpg,0,0,46,59,0,105
5913086401.jpg,14,70,19,0,0,103
5913526574.jpg,0,0,31,73,2,106
5914023763.jpg,0,0,26,73,7,106
5914304035.jpg,0,8,69,25,0,102
5914413530.jpg,1,2,50,54,1,108
5914417617.jpg,0,0,51,61,1,113
5914426709.jpg,0,1,56,43,2,102
5914848066.jpg,0,2,26,77,6,111
5914999740.jpg,0,5,70,23,0,98
5915008700.jpg,1,19,68,15,0,103
5915252762.jpg,1,47,53,3,0,104
5916873718.jpg,1,30,59,16,0,106
5917296642.jpg,16,66,25,1,0,108
5919030075.jpg,1,38,60,6,0,105
5919706356.jpg,1,23,64,11,0,99
5920168142.jpg,1,0,21,78,5,105
5920736883.jpg,1,12,96,27,0,136
5920883206.jpg,0,5,68,29,0,102
5921291430.jpg,0,7,53,49,1,110
5921674068.jpg,0,1,70,33,1,105
5922077897.jpg,0,6,53,37,1,97
5922538133.jpg,2,30,65,2,0,99
5922588235.jpg,0,1,36,60,6,103
5923029266.jpg,0,2,51,57,0,110
5923067948.jpg,0,0,39,60,4,103
5924110639.jpg,0,55,71,2,0,128
5925110976.jpg,5,78,26,0,0,109
5925314446.jpg,0,2,38,53,8,101
5925658885.jpg,0,15,86,20,0,121
5926348208.jpg,0,13,55,35,0,103
5927112319.jpg,0,2,46,49,2,99
5928144781.jpg,0,1,19,81,4,105
5930701704.jpg,0,6,57,43,0,106
5930876150.jpg,0,7,70,28,0,105
5932454750.jpg,1,6,47,45,1,100
5932521378.jpg,4,70,30,2,0,106
5932591132.jpg,47,46,15,0,0,108
5932756634.jpg,0,2,58,45,0,105
5933359823.jpg,0,15,77,16,0,108
5933439918.jpg,0,19,78,8,0,105
5934416034.jpg,0,2,49,51,4,106
5935217683.jpg,0,7,56,39,0,102
5935609907.jpg,0,3,75,28,0,106
5935910099.jpg,0,3,57,37,2,99
5936087565.jpg,0,12,63,26,0,101
5936297940.jpg,0,0,45,61,1,107
5936466945.jpg,0,19,78,13,0,110
5936518143.jpg,0,2,62,45,1,110
5936667753.jpg,2,46,56,5,0,109
5937141958.jpg,0,2,67,39,0,108
5938961229.jpg,0,4,80,26,0,110
5939994525.jpg,1,44,55,2,0,102
594061158.jpg,0,0,22,77,6,105
5941719690.jpg,0,2,48,53,0,103
5941759615.jpg,5,65,33,2,0,105
5942438965.jpg,0,22,79,11,0,112
5943227958.jpg,0,1,33,67,5,106
5944469044.jpg,0,12,56,36,1,105
5945639421.jpg,1,19,61,22,2,105
5946379420.jpg,0,10,74,11,1,96
5947239727.jpg,0,3,55,39,1,98
5948128813.jpg,0,1,53,74,1,129
5948378050.jpg,0,14,62,27,0,103
5948782020.jpg,20,70,14,2,0,106
5949374499.jpg,0,0,27,74,5,106
5950051723.jpg,0,2,33,67,2,104
5950379360.jpg,0,3,40,59,8,110
5950764081.jpg,0,1,40,62,1,104
5951267818.jpg,1,2,42,60,1,106
5952909406.jpg,0,15,62,23,0,100
5952914370.jpg,0,0,8,71,21,100
5952945336.jpg,0,0,56,54,1,111
5952977231.jpg,0,2,57,44,2,105
5955759351.jpg,1,34,66,6,0,107
5955805991.jpg,0,0,27,79,2,108
5955821366.jpg,0,3,68,35,1,107
5956264742.jpg,0,10,42,53,5,110
5956532834.jpg,29,67,5,0,0,101
5956733523.jpg,0,7,68,29,1,105
5957529687.jpg,0,1,32,75,3,111
5958225311.jpg,0,1,40,70,4,115
5958527369.jpg,0,1,27,78,5,111
5958950790.jpg,7,68,32,1,0,108
5959178118.jpg,0,23,61,20,0,104
5959274849.jpg,2,33,56,18,0,109
5959668491.jpg,0,1,37,59,6,103
5960283649.jpg,0,48,56,7,0,111
5961150371.jpg,0,1,16,72,23,112
5961872098.jpg,47,50,4,0,0,101
5962747.jpg,20,73,16,0,0,109
5963098166.jpg,7,55,43,3,0,108
5963776272.jpg,7,85,11,3,0,106
5964504987.jpg,0,2,40,61,2,105
5964655534.jpg,0,28,67,8,0,103
5965102816.jpg,0,1,33,70,1,105
5965133754.jpg,1,24,62,17,0,104
5965181934.jpg,0,6,65,34,0,105
5965591233.jpg,5,48,47,5,0,105
596587243.jpg,0,5,52,48,1,106
5966496820.jpg,0,0,44,61,0,105
5966712198.jpg,0,8,70,27,0,105
5966778623.jpg,4,59,35,2,0,100
5967167167.jpg,0,4,54,47,0,105
5967293937.jpg,0,8,54,43,2,107
5968252137.jpg,0,5,61,40,0,106
5968485889.jpg,0,0,11,95,4,110
5968558261.jpg,0,1,35,67,2,105
5969471767.jpg,0,18,79,4,0,101
5970029392.jpg,0,5,59,43,0,107
5971260303.jpg,0,6,69,24,0,99
5971597371.jpg,0,1,36,69,2,108
5971762123.jpg,0,0,42,63,1,106
5973089672.jpg,0,1,29,64,7,101
5973209084.jpg,38,66,5,0,0,109
5973304617.jpg,0,7,48,55,2,112
5974147290.jpg,26,67,10,1,0,104
5974719661.jpg,25,60,23,0,0,108
5974844404.jpg,0,2,49,48,4,103
5975565227.jpg,0,29,74,9,0,112
5976052920.jpg,0,8,66,28,2,104
5976377870.jpg,0,13,75,17,0,105
5977841815.jpg,0,0,12,78,19,109
5977893194.jpg,0,17,59,31,0,107
5979005595.jpg,0,2,31,104,3,140
5979159909.jpg,0,2,52,53,0,107
5979161459.jpg,0,8,67,34,0,109
5980068668.jpg,0,1,50,52,2,105
5980262015.jpg,1,39,65,9,0,114
5982393408.jpg,0,0,11,85,11,107
5984121563.jpg,32,70,5,1,0,108
5984140443.jpg,0,5,50,51,0,106
5985353334.jpg,0,4,62,34,0,100
5986724634.jpg,0,3,57,48,2,110
5987364665.jpg,0,2,77,28,1,108
5987384542.jpg,0,0,18,66,18,102
5987658762.jpg,0,4,48,48,1,101
5990072932.jpg,0,2,76,32,0,110
5991710179.jpg,0,4,79,23,0,106
5992863973.jpg,0,0,38,63,5,106
5993545370.jpg,0,1,36,66,0,103
5993869890.jpg,0,1,17,80,7,105
5993929800.jpg,0,0,6,97,7,110
5994198578.jpg,0,2,30,70,1,103
5994370430.jpg,0,1,45,53,3,102
5995040588.jpg,0,0,9,84,7,100
5995083892.jpg,0,15,61,29,0,105
5995809590.jpg,1,30,64,8,0,103
5996266717.jpg,1,3,58,76,2,140
5996293393.jpg,0,2,41,56,1,100
5996648026.jpg,0,5,64,33,0,102
5996831643.jpg,2,65,41,0,0,108
5997968998.jpg,0,3,73,29,0,105
5998921543.jpg,10,73,27,1,0,111
5999140032.jpg,6,31,57,6,2,102
5999303076.jpg,1,40,60,2,0,103
5999450318.jpg,2,32,63,14,0,111
5999962453.jpg,0,0,11,81,8,100
6000347443.jpg,0,2,61,76,0,139
6000377344.jpg,2,34,61,11,0,108
6000772290.jpg,0,0,19,78,8,105
6000896987.jpg,0,1,53,44,2,100
6001045244.jpg,0,0,23,75,12,110
6001214984.jpg,0,4,58,43,1,106
6001258616.jpg,0,1,58,44,0,103
6001444866.jpg,9,83,17,1,0,110
6001560793.jpg,5,29,57,15,0,106
6001836316.jpg,2,45,47,9,2,105
6002391220.jpg,0,6,42,57,2,107
6002788833.jpg,0,2,59,44,1,106
6003444578.jpg,0,1,20,70,11,102
6003830397.jpg,7,71,28,0,0,106
6003925442.jpg,8,70,19,1,0,98
6004179446.jpg,1,11,59,30,0,101
6004662053.jpg,0,0,45,57,1,103
6005119430.jpg,1,12,70,16,0,99
6006544496.jpg,0,28,63,13,0,104
6007032209.jpg,19,82,11,1,0,113
6008172185.jpg,0,10,58,38,3,109
6008267730.jpg,5,72,26,1,0,104
6010335101.jpg,0,1,35,72,3,111
6011182310.jpg,13,72,23,3,0,111
6011321842.jpg,0,1,75,26,0,102
6011443641.jpg,15,69,22,0,0,106
6012494248.jpg,4,61,31,1,0,97
6013203590.jpg,6,73,28,0,0,107
6014996044.jpg,22,76,8,0,0,106
6015032576.jpg,2,38,55,9,0,104
6015497423.jpg,0,6,68,31,0,105
6015802455.jpg,0,1,27,82,1,111
6015806731.jpg,0,0,13,84,15,112
6015956857.jpg,2,18,69,10,0,99
6016351794.jpg,0,1,39,64,3,107
6016403844.jpg,0,1,12,64,30,107
6018292739.jpg,0,2,13,76,11,102
6018448805.jpg,2,47,56,0,0,105
6018954377.jpg,1,11,69,27,1,109
6019043810.jpg,0,29,65,8,0,102
6019255824.jpg,0,26,73,7,0,106
6019634729.jpg,0,2,52,45,1,100
6019945837.jpg,1,27,63,13,0,104
6021031344.jpg,0,1,42,63,1,107
6021411453.jpg,0,13,74,23,0,110
6021481506.jpg,1,70,34,2,0,107
6022378177.jpg,0,34,60,9,1,104
6022545118.jpg,2,32,54,12,0,100
6022867548.jpg,0,18,92,25,0,135
6024552297.jpg,28,65,17,1,0,111
6024842797.jpg,5,55,43,1,0,104
6025425827.jpg,0,40,56,8,0,104
6026252669.jpg,0,7,74,25,0,106
6026326925.jpg,0,1,69,39,1,110
6026481577.jpg,4,34,62,2,0,102
6027079771.jpg,9,59,40,2,0,110
6027104916.jpg,0,5,36,56,3,100
6027592169.jpg,0,22,73,10,0,105
6027700445.jpg,2,32,61,12,0,107
6028150139.jpg,12,60,29,2,0,103
6028637115.jpg,5,48,45,4,0,102
6029121560.jpg,0,1,48,58,0,107
6029275021.jpg,0,3,40,55,1,99
6030228496.jpg,0,0,21,83,3,107
6030949586.jpg,0,16,68,21,1,106
6031428768.jpg,0,0,28,69,9,106
6031659162.jpg,0,0,48,58,3,109
6031843630.jpg,0,0,37,72,4,113
6032331327.jpg,0,14,63,29,0,106
6033104227.jpg,0,1,26,72,6,105
6034206796.jpg,0,4,57,40,0,101
6034305010.jpg,23,63,20,0,0,106
6035124340.jpg,0,0,30,70,3,103
6035849303.jpg,0,3,64,44,0,111
6036947560.jpg,0,0,21,79,3,103
6037494854.jpg,0,16,72,19,0,107
6038209414.jpg,0,3,43,54,2,102
6038295974.jpg,1,31,64,11,0,107
6038701648.jpg,9,60,30,0,0,99
6039555736.jpg,0,1,22,80,4,107
6039986831.jpg,0,14,89,45,4,152
6040260022.jpg,2,59,35,7,0,103
6041797981.jpg,0,2,73,34,0,109
6042672092.jpg,0,22,64,13,0,99
6043711166.jpg,0,3,54,53,1,111
6044839741.jpg,0,3,41,61,1,106
6044933517.jpg,0,0,22,80,3,105
6045595814.jpg,0,7,49,45,1,102
6045753888.jpg,0,10,57,39,2,108
6046652289.jpg,0,0,34,64,4,102
6046933267.jpg,0,1,23,81,5,110
6047228959.jpg,1,7,50,43,1,102
6048178491.jpg,6,57,34,2,0,99
6048377722.jpg,0,2,37,58,5,102
6050570749.jpg,2,45,70,6,0,123
6051776132.jpg,0,0,24,73,10,107
6052522172.jpg,0,5,53,52,0,110
6052669253.jpg,0,4,49,48,0,101
6052980564.jpg,0,5,37,61,5,108
6052981024.jpg,0,8,44,54,1,107
6053711143.jpg,1,15,70,19,0,105
6054384333.jpg,1,13,48,39,2,103
6055173386.jpg,0,4,42,57,3,106
6056249968.jpg,0,32,65,11,1,109
6059213593.jpg,0,4,59,42,1,106
6059364561.jpg,0,2,33,63,3,101
6059439026.jpg,1,5,55,46,6,113
6059676315.jpg,0,4,47,52,5,108
6060968148.jpg,0,8,57,44,3,112
6061284714.jpg,0,1,38,62,3,104
6061619361.jpg,1,34,60,9,0,104
6062434084.jpg,0,19,75,9,0,103
6063249330.jpg,0,25,50,29,3,107
6063545051.jpg,2,31,60,11,0,104
6064738730.jpg,0,4,39,63,1,107
6065678020.jpg,0,6,44,51,4,105
6065704403.jpg,0,3,55,50,2,110
6066096952.jpg,1,11,74,23,0,109
6066179576.jpg,0,19,76,14,0,109
6066562802.jpg,0,3,45,56,1,105
6067571211.jpg,0,4,52,50,1,107
6067656779.jpg,0,0,37,68,4,109
6068598546.jpg,0,4,57,42,0,103
6068776554.jpg,0,7,62,38,0,107
6070920773.jpg,0,0,19,86,6,111
6070993297.jpg,0,13,96,17,0,126
6071037995.jpg,21,67,15,0,0,103
6071930227.jpg,29,75,4,1,0,109
6072006649.jpg,1,8,57,64,0,130
6072373526.jpg,0,0,50,54,0,104
6072752880.jpg,0,3,51,50,0,104
6073381897.jpg,0,1,36,72,1,110
6073506056.jpg,0,2,44,53,7,106
6074442813.jpg,0,3,67,36,2,108
6074911475.jpg,0,24,70,8,0,102
6075825527.jpg,0,11,63,29,1,104
6077061574.jpg,0,2,51,57,1,111
6077250722.jpg,0,4,75,27,2,108
6077930890.jpg,8,66,26,1,0,101
6078173140.jpg,1,0,35,65,4,105
6078472527.jpg,0,4,69,32,0,105
6079223986.jpg,0,3,66,39,0,108
6080237953.jpg,0,7,71,25,0,103
6080350914.jpg,0,0,27,75,5,107
6080905239.jpg,0,0,19,77,6,102
6081414146.jpg,0,12,76,19,0,107
6082438802.jpg,1,1,38,65,0,105
6084731334.jpg,1,51,45,5,0,102
6087235314.jpg,0,13,83,15,0,111
6087381283.jpg,0,6,55,45,0,106
6087844508.jpg,0,2,42,61,4,109
6088173087.jpg,0,1,54,50,0,105
6088627872.jpg,0,2,36,68,4,110
6088697532.jpg,0,16,73,19,1,109
6088929536.jpg,0,1,35,88,4,128
6090586494.jpg,0,0,47,64,0,111
6091930648.jpg,0,5,44,57,3,109
6092043977.jpg,1,3,48,52,3,107
6092350487.jpg,0,0,49,57,0,106
6092502687.jpg,1,16,89,5,0,111
6093133362.jpg,2,31,45,26,1,105
6093527262.jpg,0,1,21,72,8,102
6094279767.jpg,0,11,60,33,0,104
6095610288.jpg,4,60,37,7,0,108
6095633645.jpg,5,59,40,5,0,109
6096610009.jpg,0,2,56,49,1,108
6096713881.jpg,1,53,46,4,0,104
6098070477.jpg,0,6,58,42,0,106
6098120607.jpg,34,85,20,2,0,141
6098553690.jpg,5,42,55,6,0,108
6098945608.jpg,0,1,29,73,7,110
6098953309.jpg,0,5,65,28,1,99
6099389158.jpg,6,61,36,2,0,105
6100280225.jpg,0,15,61,23,0,99
6100334587.jpg,0,14,70,25,1,110
6102774302.jpg,0,10,74,26,0,110
6103897334.jpg,22,76,7,0,0,105
6104666546.jpg,0,5,62,51,2,120
610496828.jpg,0,0,24,70,7,101
6105670251.jpg,0,3,17,86,6,112
6106078585.jpg,0,1,62,31,1,95
6106478357.jpg,0,8,79,20,0,107
6106890458.jpg,0,8,71,28,0,107
6107208468.jpg,0,3,58,44,0,105
6107409429.jpg,0,14,71,19,0,104
6107838272.jpg,1,35,68,8,0,112
6109808754.jpg,0,1,27,78,3,109
6110951544.jpg,0,3,14,70,13,100
6111148526.jpg,6,79,13,0,0,98
6112454258.jpg,0,12,64,27,0,103
6112534853.jpg,0,20,71,17,0,108
6112607748.jpg,0,3,41,55,4,103
611264152.jpg,0,15,67,26,1,109
6112648095.jpg,0,3,49,50,0,102
6113347868.jpg,0,29,62,13,2,106
6113677746.jpg,0,1,36,64,3,104
6113689999.jpg,0,0,26,72,4,102
6114016805.jpg,0,3,64,44,0,111
6114724699.jpg,1,27,69,6,0,103
6114847662.jpg,0,2,67,44,0,113
6114886448.jpg,0,0,32,72,2,106
6115396985.jpg,0,5,44,52,3,104
6115480209.jpg,0,8,55,35,2,100
6116188135.jpg,0,1,31,74,1,107
6117273943.jpg,0,0,29,71,3,103
611785273.jpg,10,61,31,0,0,102
6118735934.jpg,0,0,34,66,10,110
6118739597.jpg,1,25,76,7,0,109
6118760299.jpg,0,0,32,64,8,104
6119101323.jpg,0,2,60,41,0,103
6119482341.jpg,0,2,58,48,2,110
6119560603.jpg,0,1,12,78,11,102
6120678876.jpg,0,34,63,13,0,110
6121503317.jpg,0,3,34,62,1,100
6121672426.jpg,1,27,75,3,0,106
6121771164.jpg,0,0,19,79,7,105
6121783761.jpg,0,10,66,37,0,113
6122580003.jpg,42,54,14,0,0,110
6123127594.jpg,0,1,47,50,2,100
6123909061.jpg,0,3,43,55,1,102
6124044226.jpg,0,0,35,58,4,97
6124674840.jpg,1,3,53,51,0,108
6125004754.jpg,0,2,49,54,1,106
6125799438.jpg,0,0,35,62,7,104
6127342377.jpg,3,62,39,0,0,104
6127748837.jpg,0,0,53,54,1,108
6128176020.jpg,4,68,37,1,0,110
6128487555.jpg,3,70,34,1,0,108
6128600017.jpg,0,0,18,74,10,102
6128722390.jpg,0,5,69,34,0,108
6128851294.jpg,0,4,68,35,1,108
6129702417.jpg,3,11,54,38,0,106
6130471976.jpg,28,69,8,1,0,106
6131302144.jpg,0,0,31,75,3,109
6131345309.jpg,0,0,41,60,2,103
6132160018.jpg,9,77,33,0,0,119
6132687106.jpg,0,1,17,75,12,105
6132687448.jpg,0,13,69,21,1,104
6133227550.jpg,1,18,70,13,1,103
6133915607.jpg,0,5,77,17,0,99
6135085548.jpg,10,53,39,3,0,105
6136695263.jpg,1,37,58,12,0,108
6138227307.jpg,0,0,22,76,4,102
6138363884.jpg,0,1,33,77,2,113
6138545533.jpg,0,21,75,13,1,110
6139148199.jpg,3,40,58,6,0,107
6141644899.jpg,0,0,48,55,1,104
6141827403.jpg,0,2,31,79,2,114
6142185721.jpg,1,48,43,6,0,98
6142593562.jpg,0,18,73,14,0,105
6142750214.jpg,0,5,79,29,0,113
6142852545.jpg,1,11,57,36,0,105
6143005598.jpg,17,71,21,0,0,109
6143020134.jpg,1,4,65,60,2,132
6143211622.jpg,1,3,46,75,1,126
6143633711.jpg,0,4,61,41,0,106
6143698715.jpg,7,62,34,0,0,103
6144141675.jpg,6,32,58,7,0,103
6144182512.jpg,2,46,60,0,0,108
6144690260.jpg,0,4,29,63,4,100
6144702078.jpg,0,21,64,18,0,103
6146146023.jpg,0,0,12,91,2,105
6146595160.jpg,0,2,45,60,0,107
6147028264.jpg,0,1,61,43,0,105
6147638271.jpg,0,2,27,71,5,105
6147756679.jpg,0,14,68,27,1,110
6148781935.jpg,0,1,30,71,2,104
6149089572.jpg,0,1,38,63,3,105
6149327841.jpg,1,21,85,5,0,112
6149786725.jpg,1,3,44,54,3,105
615034576.jpg,60,48,1,0,0,109
6150431643.jpg,0,17,62,21,2,102
6151722057.jpg,0,1,35,62,4,102
6153674206.jpg,0,0,30,74,3,107
6153807982.jpg,0,3,44,56,0,103
6153962968.jpg,1,46,50,5,0,102
6153984860.jpg,0,23,72,14,1,110
6153987026.jpg,0,1,28,103,1,133
6154151584.jpg,4,30,69,7,0,110
6154181656.jpg,1,5,54,44,2,106
6154682169.jpg,0,10,72,21,0,103
6156825791.jpg,0,2,63,40,1,106
6157269517.jpg,0,18,76,16,0,110
6157377531.jpg,0,2,41,60,2,105
6158806771.jpg,48,51,6,1,0,106
6160181184.jpg,0,0,28,76,2,106
6160253188.jpg,12,72,23,1,0,108
6160448268.jpg,3,35,62,4,0,104
6160450342.jpg,5,52,45,4,0,106
6162009461.jpg,0,4,65,38,1,108
6162806548.jpg,1,7,65,36,0,109
6162845121.jpg,0,3,34,59,3,99
6163494059.jpg,0,4,35,59,5,103
6163563949.jpg,0,2,39,57,1,99
6163576407.jpg,0,3,68,38,1,110
6163642388.jpg,0,2,40,53,1,96
6163705024.jpg,0,0,29,69,7,105
6164110615.jpg,0,9,78,19,0,106
6164643779.jpg,0,2,45,54,2,103
6166445475.jpg,4,32,53,11,0,100
6166626410.jpg,0,20,81,4,0,105
6166766826.jpg,0,1,51,53,2,107
616692637.jpg,0,54,41,3,0,98
6167276187.jpg,44,42,10,0,0,96
6167489115.jpg,0,1,51,50,0,102
6167876275.jpg,0,1,52,46,2,101
6168174174.jpg,0,7,67,30,0,104
6169499538.jpg,0,0,24,75,8,107
6169751513.jpg,0,3,43,54,2,102
6170589548.jpg,0,0,72,41,0,113
6170767458.jpg,1,1,58,42,4,106
6171193930.jpg,8,64,35,1,0,108
6171205916.jpg,0,10,74,16,0,100
6171792130.jpg,0,1,26,74,0,101
6172349199.jpg,1,4,34,58,10,107
6172964730.jpg,18,73,9,1,0,101
6173003449.jpg,0,1,39,63,2,105
61745002.jpg,2,35,58,14,0,109
6175048748.jpg,0,1,48,53,1,103
6175206335.jpg,0,7,59,41,1,108
6175384810.jpg,0,3,56,42,1,102
6175479501.jpg,1,7,65,31,0,104
6176401677.jpg,5,72,26,2,0,105
6177131907.jpg,0,9,74,22,0,105
6177166693.jpg,0,1,34,62,5,102
6177663697.jpg,0,2,45,62,2,111
6178467080.jpg,0,0,31,74,3,108
6178888063.jpg,0,5,64,32,0,101
6179066994.jpg,0,4,71,28,1,104
6180251027.jpg,0,4,51,53,0,108
6180327231.jpg,0,0,11,79,11,101
6180360861.jpg,0,1,59,46,1,107
6181551181.jpg,0,10,79,19,0,108
6182410940.jpg,0,2,59,52,1,114
6183915148.jpg,3,60,40,2,0,105
6184879643.jpg,1,3,59,41,1,105
6185806763.jpg,0,0,24,83,7,114
6186480885.jpg,1,12,60,40,1,114
6186608340.jpg,1,51,54,8,0,114
6188110673.jpg,0,0,39,66,1,106
6188375845.jpg,5,48,45,7,0,105
6189434531.jpg,1,24,102,14,0,141
6190085634.jpg,2,27,57,21,0,107
6190472459.jpg,0,3,64,42,3,112
6190639250.jpg,0,4,51,71,3,129
6190643783.jpg,0,0,31,76,3,110
6191653562.jpg,0,1,30,72,3,106
6192180077.jpg,0,1,44,61,1,107
6192537618.jpg,0,1,60,70,1,132
6193425785.jpg,0,5,50,46,0,101
6194409059.jpg,0,0,14,81,10,105
6194607609.jpg,0,1,23,74,10,108
6194753185.jpg,0,1,34,73,1,109
6197628088.jpg,0,0,35,72,2,109
6198414386.jpg,0,8,72,22,2,104
6198870834.jpg,0,14,56,31,4,105
6199129652.jpg,0,9,56,37,1,103
6199370121.jpg,0,0,28,70,8,106
6199923383.jpg,0,28,74,4,0,106
6200906518.jpg,0,9,66,24,0,99
6201268474.jpg,1,7,45,45,2,100
6201290598.jpg,0,1,63,42,0,106
6201330007.jpg,0,5,45,48,2,100
6202357240.jpg,0,19,77,10,0,106
6202637984.jpg,0,0,30,77,0,107
6204572206.jpg,0,1,33,73,6,113
62049415.jpg,0,37,57,9,0,103
6205007970.jpg,0,6,57,44,1,108
6205974624.jpg,3,21,66,16,0,106
6206537563.jpg,3,35,53,7,0,98
6206641810.jpg,0,0,34,65,5,104
6207546656.jpg,1,15,69,16,1,102
6208184332.jpg,3,64,36,3,0,106
6208522710.jpg,0,2,53,48,3,106
6208981295.jpg,0,3,62,43,1,109
6209362711.jpg,1,3,47,56,1,108
6210021795.jpg,0,19,64,22,0,105
6210436753.jpg,2,44,49,10,0,105
6210494281.jpg,0,7,72,27,1,107
6211550250.jpg,0,27,86,9,0,122
6211562802.jpg,0,6,70,32,2,110
6214101646.jpg,0,7,77,22,1,107
6216457478.jpg,0,1,61,42,1,105
6216628901.jpg,0,1,21,70,9,101
6218336714.jpg,0,0,20,88,4,112
6219475255.jpg,0,7,71,25,1,104
6220511513.jpg,0,8,65,35,0,108
6220758013.jpg,0,3,58,45,0,106
6221634862.jpg,2,33,65,5,0,105
6222011944.jpg,0,8,60,36,0,104
6222668667.jpg,0,4,38,59,2,103
6224117679.jpg,1,12,83,12,0,108
6224309834.jpg,28,82,21,1,0,132
6224567547.jpg,1,44,54,5,0,104
6224584485.jpg,1,70,27,5,0,103
6225839332.jpg,0,7,64,31,0,102
6225884368.jpg,50,46,6,0,0,102
6226065978.jpg,0,8,53,46,1,108
6226355668.jpg,0,1,52,53,1,107
6226545880.jpg,0,2,57,41,0,100
6226958482.jpg,0,1,25,66,11,103
6227646726.jpg,0,4,61,40,0,105
6227862554.jpg,0,2,42,65,3,112
6227951538.jpg,3,31,65,8,0,107
6228242896.jpg,1,28,70,10,0,109
6228278450.jpg,0,8,55,42,0,105
6228740926.jpg,0,3,49,50,3,105
6229984844.jpg,0,7,80,20,0,107
6230011878.jpg,0,1,25,62,10,98
6232031392.jpg,0,1,46,54,5,106
6232083444.jpg,0,15,73,14,0,102
6233076325.jpg,0,2,29,72,1,104
6233367790.jpg,1,6,71,27,0,105
62339435.jpg,0,4,48,54,2,108
6235008903.jpg,0,1,44,57,3,105
6235266506.jpg,2,16,62,26,0,106
6236533476.jpg,0,3,55,80,0,138
6237039351.jpg,0,2,43,61,0,106
6237051127.jpg,2,13,54,31,1,101
6237170971.jpg,0,16,51,40,0,107
6237287200.jpg,3,57,45,0,0,105
6237907286.jpg,0,1,51,53,0,105
6238087656.jpg,0,4,57,35,1,97
6238203210.jpg,2,36,49,19,1,107
6238346062.jpg,0,1,28,83,2,114
6238543010.jpg,0,6,62,35,1,104
6238988012.jpg,0,24,68,13,0,105
6239374380.jpg,0,0,17,83,7,107
6239620274.jpg,0,0,32,68,1,101
6239948477.jpg,1,30,67,6,0,104
6243575043.jpg,1,24,75,12,0,112
6243772733.jpg,2,54,44,1,0,101
6244943274.jpg,4,42,53,4,0,103
6245095836.jpg,0,2,64,39,0,105
6245438349.jpg,0,1,26,78,8,113
6245654215.jpg,0,0,36,62,5,103
6245749984.jpg,1,16,70,18,1,106
62458506.jpg,0,12,41,47,4,104
6246977871.jpg,24,59,22,0,0,105
6248527465.jpg,0,1,33,60,3,97
6249554399.jpg,0,1,46,53,1,101
6249766642.jpg,0,2,35,69,1,107
6250057202.jpg,0,4,45,59,0,108
62503983.jpg,10,49,34,9,0,102
6251598886.jpg,1,18,73,15,0,107
6251689254.jpg,0,34,67,1,0,102
6251795586.jpg,0,1,32,72,0,105
6252006096.jpg,5,64,56,4,0,129
6252132752.jpg,0,12,62,29,1,104
6252195920.jpg,0,3,25,70,8,106
6252279555.jpg,0,2,58,50,1,111
6252497829.jpg,0,15,65,21,0,101
6252913864.jpg,2,35,52,15,0,104
6253185409.jpg,0,34,71,3,0,108
6253604200.jpg,0,3,53,51,2,109
6253829392.jpg,0,18,49,37,4,108
6254765942.jpg,0,3,33,61,0,97
6255399920.jpg,0,1,37,63,3,104
6255404207.jpg,0,2,39,69,1,111
6255414433.jpg,0,3,69,32,0,104
6255855320.jpg,1,15,65,20,0,101
6256521905.jpg,0,2,46,55,1,104
6256829619.jpg,0,0,32,92,5,129
6256953359.jpg,0,0,38,64,1,103
6257410462.jpg,6,53,44,4,0,107
6257507740.jpg,0,8,68,38,0,114
6257550303.jpg,4,48,53,8,0,113
6258118545.jpg,2,66,35,2,0,105
6258120264.jpg,0,0,38,70,1,109
6258336058.jpg,3,52,47,2,0,104
6259041958.jpg,0,1,41,56,0,98
6259163279.jpg,1,50,46,5,0,102
6259804978.jpg,7,59,36,1,0,103
6261187277.jpg,0,24,63,13,1,101
6264153932.jpg,3,43,51,0,0,97
6264326921.jpg,0,35,62,6,0,103
6264359892.jpg,0,2,42,61,7,112
6264868738.jpg,1,41,49,7,0,98
6265723593.jpg,0,0,46,56,0,102
6266190688.jpg,0,19,74,18,0,111
6267817145.jpg,0,4,51,47,0,102
6267962364.jpg,4,20,56,27,0,107
6268176546.jpg,0,0,28,70,10,108
6268918476.jpg,0,3,43,58,2,106
6269063819.jpg,0,22,65,15,0,102
6272061393.jpg,0,1,25,74,5,105
6272882973.jpg,0,23,110,15,1,149
6272884743.jpg,0,27,67,10,0,104
6273772448.jpg,0,2,20,82,5,109
6273784733.jpg,5,47,41,9,1,103
6274128274.jpg,0,2,75,28,0,105
6274950285.jpg,0,1,21,73,4,99
6275395379.jpg,0,0,38,66,0,104
6275790989.jpg,1,34,93,12,0,140
6276334186.jpg,7,67,37,2,0,113
6277079135.jpg,0,9,77,18,2,106
6278202326.jpg,9,67,22,0,0,98
6279019362.jpg,0,5,66,34,0,105
6279173860.jpg,0,11,61,28,1,101
6279975735.jpg,0,2,69,35,0,106
6280923250.jpg,0,0,45,57,3,105
6282202152.jpg,0,0,37,66,2,105
6283537466.jpg,0,9,72,20,0,101
6283627097.jpg,0,15,72,21,0,108
6284871746.jpg,2,59,59,2,0,122
6285601097.jpg,0,3,37,66,0,106
6285698915.jpg,0,1,2,80,19,102
6285772617.jpg,2,34,78,18,0,132
6286044979.jpg,0,2,54,45,1,102
6287889158.jpg,0,10,50,44,1,105
6289164461.jpg,16,71,17,0,0,104
628981585.jpg,0,1,23,71,12,107
6290063091.jpg,0,0,41,64,0,105
6290086775.jpg,0,1,52,52,1,106
6290479072.jpg,0,7,80,41,2,130
6291431070.jpg,0,0,14,86,11,111
6292365384.jpg,1,61,41,2,0,105
6293184375.jpg,0,0,49,57,2,108
6293629106.jpg,0,37,57,2,0,96
629401204.jpg,2,44,55,6,0,107
6294378978.jpg,0,3,78,49,0,130
6294913930.jpg,0,8,67,21,0,96
6295098733.jpg,0,2,41,69,1,113
6296603222.jpg,0,1,45,54,3,103
6297143428.jpg,0,1,20,75,6,102
6298978484.jpg,1,12,62,28,1,104
6299847089.jpg,0,5,50,46,6,107
6301607249.jpg,0,9,47,43,6,105
6301736669.jpg,0,10,64,37,0,111
6302067502.jpg,0,2,39,57,1,99
6302152017.jpg,3,33,76,9,0,121
6302283687.jpg,1,55,52,4,0,112
6303415659.jpg,3,60,84,6,0,153
6303418704.jpg,7,79,20,1,0,107
6303626544.jpg,0,0,38,69,5,112
6303893419.jpg,0,11,78,13,1,103
6304784314.jpg,19,63,23,1,0,106
6305224063.jpg,17,76,12,0,0,105
6305294695.jpg,0,7,61,26,0,94
6305410399.jpg,0,0,38,67,1,106
6305573914.jpg,0,12,79,15,0,106
6305619763.jpg,2,49,49,4,0,104
6305935130.jpg,0,2,40,66,2,110
6306859998.jpg,0,1,28,77,4,110
6307302399.jpg,0,1,20,81,2,104
6308479233.jpg,0,9,64,31,0,104
6308614891.jpg,0,15,97,11,0,123
6308697965.jpg,0,8,73,24,0,105
6309109435.jpg,4,68,27,2,0,101
6309436752.jpg,0,26,60,16,1,103
6310649828.jpg,30,70,5,0,0,105
6311708784.jpg,0,10,73,27,1,111
63121245.jpg,0,33,50,18,2,103
6312611820.jpg,0,6,71,25,0,102
6316913705.jpg,0,21,81,6,0,108
6317074483.jpg,0,2,73,51,0,126
6317232957.jpg,0,2,63,37,0,102
6317292405.jpg,2,30,65,12,1,110
6318611647.jpg,1,27,65,15,0,108
6318820907.jpg,0,8,65,29,0,102
6319935355.jpg,0,0,16,86,4,106
6319992606.jpg,0,17,59,19,0,95
6320692581.jpg,0,1,41,60,6,108
6321219958.jpg,1,9,89,53,2,154
6321269427.jpg,2,48,52,4,0,106
6321717266.jpg,0,15,68,21,1,105
6321752444.jpg,0,10,69,26,0,105
632270898.jpg,0,4,50,55,3,112
6323869799.jpg,0,3,36,67,4,110
6324713970.jpg,0,0,25,81,7,113
6325240412.jpg,0,0,19,82,7,108
6326442580.jpg,0,5,68,29,2,104
6326811967.jpg,0,1,58,49,1,109
6326886913.jpg,0,52,54,0,0,106
6326902733.jpg,0,4,60,40,2,106
6327903295.jpg,0,3,57,47,5,112
6328014889.jpg,0,6,59,33,2,100
6328697192.jpg,0,0,22,86,3,111
6329144585.jpg,9,76,22,0,0,107
6329859114.jpg,5,83,18,1,0,107
6331865739.jpg,0,3,46,51,4,104
6332554758.jpg,0,1,36,65,0,102
6332564856.jpg,0,7,71,31,0,109
6332883956.jpg,36,66,1,0,0,103
6332978018.jpg,2,17,59,24,0,102
6333112690.jpg,0,6,48,50,2,106
6333581509.jpg,0,2,38,66,5,111
6333620590.jpg,0,7,77,22,0,106
6335908367.jpg,0,22,74,7,0,103
6336463501.jpg,0,5,64,33,0,102
6337822588.jpg,2,37,92,7,0,138
6339141620.jpg,0,13,70,24,0,107
6339286279.jpg,3,12,68,49,1,133
6340619552.jpg,7,72,22,2,0,103
6340836746.jpg,8,70,30,2,0,110
6341153287.jpg,0,5,48,59,0,112
6342206102.jpg,1,6,75,43,0,125
6343064519.jpg,0,0,21,72,8,101
6343807770.jpg,0,5,57,41,2,105
6344257116.jpg,0,0,32,75,4,111
6344881273.jpg,0,13,71,18,0,102
6344902938.jpg,0,1,22,81,8,112
6345193023.jpg,0,1,43,59,3,106
6345505389.jpg,0,1,56,62,1,120
6345773491.jpg,0,0,48,51,1,100
6346260646.jpg,0,10,76,19,1,106
6346767698.jpg,0,1,54,47,1,103
6346994570.jpg,0,0,22,73,11,106
6347069171.jpg,2,20,65,23,0,110
6350199154.jpg,0,28,61,17,1,107
6350910177.jpg,0,1,34,71,1,107
6351773844.jpg,0,39,62,6,0,107
6352194993.jpg,0,6,46,55,3,110
6352599641.jpg,1,13,75,17,0,106
6354614287.jpg,0,24,60,15,0,99
6360259167.jpg,0,2,42,55,9,108
6363131561.jpg,1,3,67,38,1,110
6366256547.jpg,0,3,41,61,3,108
6366296433.jpg,0,3,62,45,1,111
6366361319.jpg,0,2,41,59,1,103
6366516291.jpg,0,8,58,36,0,102
6366586615.jpg,5,50,48,3,0,106
6367495079.jpg,1,12,71,26,0,110
6368218585.jpg,0,1,38,61,5,105
6371973185.jpg,0,9,67,32,0,108
6372460147.jpg,0,7,41,59,2,109
6373766117.jpg,0,6,73,28,1,108
6376701103.jpg,1,5,67,30,0,103
6378298689.jpg,2,30,67,6,0,105
6379014005.jpg,1,40,53,10,0,104
6379443681.jpg,0,26,76,6,1,109
6383007575.jpg,0,0,21,84,3,108
6385141033.jpg,4,34,101,17,0,156
6385461657.jpg,0,2,72,58,0,132
6386599471.jpg,1,29,56,15,0,101
63888840.jpg,2,43,51,12,0,108
6389008737.jpg,1,2,43,56,2,104
6391074279.jpg,0,0,23,74,7,104
6391919133.jpg,0,3,42,52,1,98
63920904.jpg,10,32,32,27,8,109
6394609023.jpg,0,7,50,51,2,110
6395582961.jpg,0,0,16,79,5,100
6396984107.jpg,0,3,51,55,4,113
6398001637.jpg,0,1,13,88,10,112
6399276439.jpg,0,1,42,59,0,102
6403149971.jpg,5,60,38,1,0,104
640351831.jpg,0,1,45,60,3,109
6407770545.jpg,0,10,53,41,3,107
6407934435.jpg,0,2,41,60,0,103
6408708033.jpg,1,31,62,11,0,105
6408799339.jpg,0,3,43,57,1,104
6408985463.jpg,0,28,61,10,0,99
6410507631.jpg,0,1,52,47,0,100
6411216741.jpg,0,0,39,62,2,103
6411944553.jpg,0,16,67,21,0,104
6412693303.jpg,0,23,68,7,0,98
6415648509.jpg,1,3,55,48,2,109
641595598.jpg,0,0,19,86,1,106
6419047435.jpg,0,3,51,50,2,106
6419135601.jpg,0,3,67,36,3,109
6419593777.jpg,0,2,53,47,1,103
6422846525.jpg,0,1,34,64,1,100
6423969851.jpg,1,46,63,10,0,120
6424074571.jpg,13,81,16,1,0,111
6427589897.jpg,19,64,18,1,0,102
6430851513.jpg,2,51,48,1,0,102
6431960911.jpg,0,9,74,17,0,100
6433692937.jpg,1,39,57,8,0,105
6434043361.jpg,0,3,56,44,1,104
6434876963.jpg,58,40,3,0,0,101
6435747701.jpg,0,3,22,68,8,101
6437207759.jpg,0,1,27,75,3,106
6438830749.jpg,0,0,27,74,1,102
6439148467.jpg,0,3,37,56,6,102
6439499095.jpg,0,4,47,48,1,100
6440356973.jpg,1,23,66,14,0,104
6440541263.jpg,0,1,30,71,5,107
6441383857.jpg,0,1,34,65,3,103
6441809623.jpg,0,17,70,12,0,99
6443379565.jpg,0,0,39,58,7,104
6443396365.jpg,1,13,64,26,2,106
6443711585.jpg,5,36,55,9,0,105
6445980191.jpg,0,4,56,50,0,110
6449745557.jpg,0,0,27,75,0,102
6450022679.jpg,0,1,48,60,1,110
6450302367.jpg,0,5,76,26,0,107
6451339307.jpg,0,4,74,31,0,109
6452060589.jpg,0,8,65,28,0,101
6452529101.jpg,0,3,57,47,0,107
6452613567.jpg,0,0,23,73,12,108
6453185751.jpg,0,11,65,38,0,114
6453831461.jpg,11,44,46,7,0,108
6458056243.jpg,2,39,63,2,0,106
6458754563.jpg,0,2,47,49,5,103
6459542105.jpg,0,17,67,17,2,103
6459811757.jpg,0,0,50,65,0,115
6461549237.jpg,23,74,9,0,0,106
6462096609.jpg,1,17,72,12,0,102
6462502847.jpg,0,2,59,39,2,102
6464291091.jpg,0,0,23,76,4,103
6464821041.jpg,0,5,72,32,0,109
6465089945.jpg,2,40,58,1,0,101
6465343643.jpg,0,1,63,39,0,103
6467546565.jpg,5,83,19,0,0,107
6468297341.jpg,0,9,85,16,0,110
6469192803.jpg,8,71,29,0,0,108
6469390735.jpg,5,54,48,0,0,107
6470955539.jpg,0,2,64,40,0,106
6471980333.jpg,0,8,65,33,1,107
6473904775.jpg,15,63,31,2,0,111
6474704871.jpg,0,17,64,25,0,106
6475916177.jpg,0,6,67,28,1,102
6475932467.jpg,0,2,40,67,4,113
6476406225.jpg,0,1,17,93,4,115
6476717611.jpg,1,28,70,7,0,106
6479303397.jpg,14,68,18,1,0,101
6479556701.jpg,0,26,65,12,1,104
6480739257.jpg,0,30,70,11,0,111
6481674971.jpg,1,18,69,14,0,102
6483140329.jpg,7,63,31,0,0,101
6486375983.jpg,32,60,11,1,0,104
6486604889.jpg,6,39,43,13,2,103
6486906969.jpg,5,54,44,4,0,107
6489144861.jpg,0,4,50,52,0,106
6489257695.jpg,0,9,51,42,3,105
6490629733.jpg,0,1,42,59,5,107
6491835829.jpg,0,0,23,60,18,101
6493285057.jpg,0,1,30,64,4,99
6493347009.jpg,0,1,36,65,2,104
6493679161.jpg,0,4,69,30,1,104
6494527059.jpg,0,29,71,2,0,102
6495386031.jpg,0,5,46,59,2,112
6496266341.jpg,5,65,30,3,1,104
6497142149.jpg,0,13,54,36,8,111
649761301.jpg,6,80,41,0,0,127
6498451617.jpg,0,14,94,24,0,132
6500646971.jpg,0,1,24,72,0,97
6504283859.jpg,0,25,71,4,0,100
6508138341.jpg,45,61,0,0,0,106
6511236583.jpg,0,3,49,60,1,113
6512316735.jpg,0,0,53,52,1,106
6512617013.jpg,0,0,15,76,17,108
6512960549.jpg,0,3,53,46,3,105
6513274589.jpg,0,8,70,31,0,109
6513828853.jpg,32,71,5,0,0,108
6515985695.jpg,12,74,17,0,0,103
6517362491.jpg,0,5,64,35,0,104
6517732881.jpg,0,2,43,55,1,101
6520839597.jpg,0,13,62,31,0,106
6521275803.jpg,4,61,38,3,0,106
6521723915.jpg,0,2,37,55,3,97
6522952765.jpg,0,4,62,32,2,100
6523676619.jpg,1,5,75,19,1,101
6526093429.jpg,5,35,62,9,0,111
6527460609.jpg,0,2,69,57,1,129
6530075543.jpg,0,1,19,84,3,107
6530161213.jpg,0,17,67,27,0,111
6531551463.jpg,0,23,65,14,0,102
6533123895.jpg,0,0,29,72,3,104
6534182163.jpg,15,86,10,0,0,111
6534779805.jpg,4,88,42,1,0,135
6534801331.jpg,1,25,75,8,0,109
6537150655.jpg,0,0,18,78,10,106
6537249483.jpg,0,2,24,68,12,106
6537543865.jpg,9,60,34,2,0,105
6538847583.jpg,0,5,61,35,0,101
6540737111.jpg,3,14,68,19,0,104
6543370923.jpg,0,3,65,36,1,105
6543602941.jpg,0,16,47,35,0,98
6544670475.jpg,0,14,72,23,1,110
6550772311.jpg,0,8,47,51,3,109
6551619395.jpg,0,6,46,46,5,103
6553742481.jpg,44,57,3,0,0,104
6555285779.jpg,0,28,76,8,0,112
6558436183.jpg,0,1,31,66,2,100
6560010177.jpg,2,31,64,3,0,100
6561794905.jpg,0,5,57,47,1,110
6563196289.jpg,0,16,69,19,0,104
6563980965.jpg,0,0,11,81,16,108
6564623827.jpg,0,1,33,71,4,109
6564941395.jpg,0,1,45,59,2,107
656718644.jpg,16,85,24,2,0,127
6568238645.jpg,0,8,68,24,1,101
6568691361.jpg,0,5,54,43,1,103
6569563105.jpg,0,3,51,49,3,106
6569780821.jpg,1,31,89,8,0,129
6569878593.jpg,1,3,59,44,2,109
657099880.jpg,2,28,88,8,0,126
6573749079.jpg,0,2,37,66,2,107
6576363795.jpg,16,59,23,5,0,103
6576807711.jpg,0,0,23,74,6,103
6577277115.jpg,0,8,81,43,1,133
6577912541.jpg,0,0,46,49,5,100
6578628541.jpg,0,17,64,27,0,108
6579889887.jpg,0,3,55,47,1,106
6579913923.jpg,0,3,57,44,1,105
6584540793.jpg,0,1,48,52,3,104
6585039061.jpg,64,36,5,1,0,106
6585164875.jpg,0,10,62,33,1,106
6585714605.jpg,0,0,22,71,16,109
6587178245.jpg,0,2,40,65,0,107
6587673561.jpg,0,13,74,18,0,105
6590042471.jpg,4,28,65,10,0,107
6591706349.jpg,0,10,47,42,2,101
6593133897.jpg,0,7,54,44,0,105
6593145547.jpg,0,2,59,51,1,113
6594506719.jpg,0,20,73,12,0,105
6595488751.jpg,0,10,46,48,2,106
6596085063.jpg,0,4,74,29,1,108
6596093581.jpg,0,0,38,63,2,103
6596306.jpg,0,56,40,6,0,102
6598075737.jpg,0,3,46,80,0,129
6598327095.jpg,0,12,60,41,0,113
6599488221.jpg,0,1,35,72,2,110
6599596287.jpg,0,2,44,59,1,106
6599722517.jpg,7,53,39,2,0,101
6602696603.jpg,0,20,81,9,0,110
6602870035.jpg,0,1,31,73,5,110
6603102821.jpg,0,1,44,59,1,105
6603666933.jpg,0,16,79,11,0,106
6604046527.jpg,0,12,77,14,1,104
6605703733.jpg,0,2,36,63,6,107
6606950227.jpg,0,1,23,60,24,108
6608109869.jpg,0,0,44,58,0,102
6608146543.jpg,0,3,62,36,0,101
6609931137.jpg,0,4,62,50,1,117
6612589223.jpg,0,45,62,1,0,108
6613235741.jpg,6,44,48,6,0,104
6617069623.jpg,3,71,30,1,0,105
6617738113.jpg,2,29,81,15,1,128
6621080809.jpg,2,34,62,12,0,110
6621488051.jpg,0,3,53,52,1,109
6621968211.jpg,0,12,72,21,0,105
6622105827.jpg,0,0,14,85,9,108
6622490475.jpg,0,2,28,68,4,102
6622717529.jpg,0,1,32,60,11,104
6622738777.jpg,3,25,68,18,0,114
6623118287.jpg,1,19,101,27,0,148
6625886365.jpg,29,67,6,0,0,102
6626107981.jpg,0,25,77,3,0,105
6627549719.jpg,0,6,70,31,0,107
6628327223.jpg,0,2,42,58,1,103
6628854085.jpg,2,18,64,18,0,102
6629226527.jpg,0,1,52,57,0,110
6630214003.jpg,0,1,29,66,7,103
6630840931.jpg,2,26,72,10,0,110
6632573597.jpg,0,18,69,14,2,103
6633974935.jpg,0,2,34,68,0,104
6635887941.jpg,0,2,71,34,0,107
6638453859.jpg,0,2,31,68,2,103
6639033203.jpg,0,0,44,57,1,102
6640061445.jpg,0,21,67,14,0,102
6640354399.jpg,0,36,64,8,0,108
6641523883.jpg,0,2,65,41,0,108
6641795483.jpg,0,0,31,69,7,107
6642387989.jpg,0,1,21,72,8,102
6642761299.jpg,0,12,100,28,0,140
6642932619.jpg,0,4,49,49,1,103
6643514423.jpg,0,1,44,53,1,99
6643932717.jpg,9,75,22,1,0,107
6644227727.jpg,46,76,7,0,0,129
6644440429.jpg,1,54,53,0,0,108
6645063001.jpg,1,47,51,7,0,106
6647398937.jpg,0,44,56,6,0,106
6648576397.jpg,2,48,42,3,0,95
6649624069.jpg,0,3,64,37,2,106
6650873585.jpg,0,1,50,55,2,108
665094052.jpg,8,72,23,0,0,103
6652263581.jpg,0,28,67,13,0,108
6652379747.jpg,5,68,32,1,0,106
6653174291.jpg,0,8,70,22,0,100
6654258389.jpg,0,2,54,53,2,111
6654380789.jpg,0,0,24,74,6,104
6655597997.jpg,0,9,72,30,0,111
6656239161.jpg,0,39,53,4,0,96
6656519345.jpg,11,78,13,0,0,102
6656935539.jpg,34,52,10,0,0,96
6657341905.jpg,0,16,81,4,0,101
6657359355.jpg,2,41,65,2,0,110
6658108283.jpg,18,67,15,5,0,105
6658947687.jpg,1,35,55,10,2,103
6661527913.jpg,0,1,39,61,4,105
6661741471.jpg,29,71,6,0,0,106
6663294041.jpg,0,7,76,20,0,103
6663775735.jpg,0,2,37,55,7,101
6665024915.jpg,1,13,79,16,0,109
6666568019.jpg,0,0,63,41,0,104
6668846319.jpg,0,6,71,32,0,109
6669002441.jpg,0,1,45,79,4,129
6669862645.jpg,0,8,76,19,0,103
6670935319.jpg,2,13,74,16,0,105
6678741473.jpg,0,2,21,71,6,100
6679121211.jpg,0,0,30,73,3,106
6679373485.jpg,1,47,60,2,0,110
6681014309.jpg,0,10,73,24,0,107
6681296959.jpg,0,3,46,56,5,110
6681716765.jpg,0,2,38,71,2,113
6681891719.jpg,15,74,11,1,0,101
66839471.jpg,0,4,53,43,0,100
6685463337.jpg,0,4,38,56,8,106
6686438027.jpg,0,3,39,59,2,103
6688716327.jpg,0,1,26,73,4,104
6688906197.jpg,0,1,75,23,0,99
6691471103.jpg,0,2,74,27,0,103
6692795337.jpg,0,2,45,72,2,121
6693843973.jpg,1,61,37,1,0,100
6694664547.jpg,0,2,55,47,0,104
6694665963.jpg,2,41,54,13,0,110
6694669509.jpg,0,3,70,34,0,107
669490972.jpg,13,76,11,2,0,102
6696229175.jpg,3,80,21,1,0,105
6696763655.jpg,0,22,78,5,0,105
6698669369.jpg,0,0,14,79,13,106
6699302891.jpg,0,0,20,77,13,110
6701756497.jpg,0,4,50,55,1,110
6702372317.jpg,0,2,55,50,0,107
6702441233.jpg,0,0,18,81,6,105
6703759327.jpg,0,7,48,48,0,103
6705759167.jpg,1,14,67,21,0,103
6705859439.jpg,0,1,37,66,2,106
6707835355.jpg,0,2,25,77,1,105
6708577729.jpg,0,0,56,44,1,101
6708806483.jpg,0,1,45,60,0,106
6710396995.jpg,0,1,8,82,19,110
6710865793.jpg,0,1,64,39,1,105
6711319143.jpg,0,2,29,57,19,107
6711335759.jpg,0,1,40,73,8,122
6711764573.jpg,0,1,36,62,1,100
6712830935.jpg,0,1,13,65,29,108
6713488045.jpg,1,12,66,29,0,108
6720918207.jpg,1,28,84,8,0,121
6724979243.jpg,0,0,34,62,4,100
6725311751.jpg,0,10,67,30,0,107
6727094363.jpg,12,80,18,1,0,111
6727591153.jpg,0,0,39,64,4,107
6727661759.jpg,0,11,59,36,1,107
6728176335.jpg,0,2,57,45,3,107
6728215257.jpg,0,0,66,40,1,107
6729160073.jpg,0,4,39,66,2,111
6729759239.jpg,0,0,12,80,9,101
6730791971.jpg,0,2,43,59,2,106
6731073163.jpg,0,3,51,49,1,104
6731198091.jpg,0,0,15,78,9,102
6733542819.jpg,1,5,59,38,0,103
6735104841.jpg,2,7,35,62,5,111
6736392821.jpg,0,35,65,7,0,107
6737389193.jpg,0,5,44,48,4,101
6738986329.jpg,0,4,36,49,11,100
6739568529.jpg,0,5,74,21,1,101
6739930655.jpg,0,9,76,16,1,102
6741097253.jpg,0,15,71,26,0,112
6743243667.jpg,0,1,28,71,3,103
6745774611.jpg,3,61,43,1,0,108
6746049049.jpg,0,7,65,34,1,107
6746835381.jpg,0,2,19,78,4,103
6748049411.jpg,1,12,64,29,0,106
6748287295.jpg,0,6,52,32,4,94
6748422197.jpg,0,1,27,70,4,102
6748739885.jpg,2,31,66,10,0,109
6749061363.jpg,0,2,67,33,1,103
6749191929.jpg,0,8,74,24,0,106
6749380301.jpg,0,2,50,51,1,104
6749631813.jpg,0,0,22,70,15,107
6752719165.jpg,0,10,64,32,0,106
6755602871.jpg,1,26,60,23,0,110
6755644805.jpg,0,0,6,88,16,110
6757989209.jpg,0,0,45,62,2,109
6759678037.jpg,81,27,3,0,0,111
6762482065.jpg,0,2,55,42,4,103
6764494191.jpg,3,41,59,6,0,109
6766502563.jpg,0,9,57,39,3,108
6766779583.jpg,0,4,49,60,0,113
6766818267.jpg,2,37,55,13,0,107
6769268131.jpg,0,4,43,50,2,99
6769877279.jpg,0,1,36,64,3,104
6771336533.jpg,11,67,28,1,0,107
6772091149.jpg,0,11,73,23,1,108
6775082758.jpg,0,7,61,27,1,96
6775674634.jpg,0,23,64,15,0,102
6776603937.jpg,0,1,78,49,0,128
6777036983.jpg,0,3,25,72,3,103
6778568929.jpg,0,10,49,49,2,110
677921002.jpg,0,1,47,51,1,100
6779633762.jpg,0,4,40,60,1,105
6780493014.jpg,0,1,9,94,6,110
6781694906.jpg,1,12,78,16,0,107
6782077853.jpg,47,92,10,0,0,149
6782624408.jpg,3,53,43,4,0,103
6782627736.jpg,0,0,49,50,1,100
6782909752.jpg,0,11,50,41,4,106
6784024897.jpg,0,0,26,72,6,104
6784185258.jpg,55,40,3,0,0,98
6785564222.jpg,6,29,54,20,0,109
6785846367.jpg,0,0,43,61,0,104
6786638173.jpg,0,2,59,47,0,108
6787512667.jpg,0,0,40,61,1,102
6787714050.jpg,0,7,71,32,2,112
6788163039.jpg,0,7,65,48,1,121
6788530155.jpg,11,66,24,0,0,101
6788551083.jpg,66,42,1,0,0,109
6788897458.jpg,0,2,70,65,0,137
6789727386.jpg,0,2,55,50,0,107
6789846783.jpg,56,50,6,0,0,112
6790082633.jpg,1,11,67,24,1,104
6791354533.jpg,6,64,33,3,0,106
6791434529.jpg,0,2,37,60,5,104
6791461596.jpg,0,5,78,26,0,109
6791631777.jpg,0,1,25,65,16,107
6793483796.jpg,0,4,63,44,0,111
6793575356.jpg,0,12,72,26,0,110
6793966090.jpg,1,3,55,50,1,110
6795087227.jpg,16,70,17,3,0,106
6795803065.jpg,1,58,41,3,0,103
6796559908.jpg,4,68,31,2,0,105
6796759928.jpg,0,4,43,84,3,134
6797193823.jpg,0,31,71,3,0,105
6798093193.jpg,0,7,72,22,1,102
6798101803.jpg,0,4,43,60,0,107
6798563238.jpg,1,25,63,17,0,106
6798891367.jpg,0,1,28,66,7,102
6799140939.jpg,0,12,61,28,1,102
6799306335.jpg,28,68,12,0,0,108
6800438108.jpg,0,0,23,80,9,112
6800703361.jpg,0,1,45,59,2,107
6801180487.jpg,2,71,33,1,0,107
6801462257.jpg,1,11,62,31,1,106
6801568370.jpg,1,36,61,5,0,103
6803183748.jpg,0,5,81,20,0,106
6803244763.jpg,0,0,30,78,2,110
6803834950.jpg,0,4,58,60,1,123
6803864259.jpg,0,3,71,33,0,107
6804651008.jpg,0,20,77,16,0,113
6805903671.jpg,0,0,30,74,4,108
6807214777.jpg,0,16,66,20,0,102
6808449405.jpg,0,3,59,43,3,108
6808473551.jpg,1,29,67,5,0,102
6809126683.jpg,0,29,66,5,0,100
6809286909.jpg,16,81,8,0,0,105
6810784384.jpg,0,30,68,7,0,105
6810820079.jpg,0,0,26,81,3,110
6811037194.jpg,8,48,44,5,0,105
6811333589.jpg,0,2,46,88,3,139
6812098169.jpg,0,1,25,71,3,100
6812883252.jpg,0,5,69,66,0,140
6813135887.jpg,0,0,54,46,1,101
6813481975.jpg,0,3,70,54,0,127
6813687716.jpg,0,7,59,29,0,95
6814736135.jpg,0,38,62,11,0,111
6814873580.jpg,13,66,25,3,0,107
6815253808.jpg,2,44,59,1,1,107
6815460393.jpg,0,10,65,27,0,102
6817139940.jpg,1,6,72,26,1,106
6818185643.jpg,0,9,46,44,6,105
6818454464.jpg,0,3,47,49,6,105
6818698150.jpg,0,6,56,36,1,99
6818984013.jpg,0,31,69,9,0,109
6820819077.jpg,0,3,40,54,1,98
6823375889.jpg,4,28,68,5,0,105
682337857.jpg,0,16,54,35,0,105
6823515263.jpg,0,4,58,38,1,101
6824806522.jpg,5,73,21,2,0,101
6825162524.jpg,15,72,20,0,0,107
6825556474.jpg,0,6,68,25,1,100
6826290090.jpg,0,3,37,59,4,103
6827213168.jpg,0,33,65,9,0,107
6827495732.jpg,1,18,70,15,0,104
6827830343.jpg,5,74,30,0,0,109
6828049746.jpg,0,1,40,65,4,110
6828526069.jpg,0,2,56,39,1,98
6829189111.jpg,0,2,44,59,0,105
6829439085.jpg,2,15,67,23,0,107
6830281130.jpg,0,1,23,72,5,101
6831480328.jpg,0,0,32,64,8,104
6831984052.jpg,0,2,29,75,1,107
6832136083.jpg,3,58,39,1,0,101
6832446699.jpg,0,30,88,8,0,126
6833109332.jpg,0,2,37,69,4,112
6834245510.jpg,0,5,80,71,1,157
6834514891.jpg,8,78,19,1,0,106
6834902092.jpg,0,8,115,29,0,152
6835007518.jpg,2,68,37,1,0,108
6835820588.jpg,0,7,78,23,0,108
6836104801.jpg,0,1,39,61,2,103
6836874905.jpg,0,0,43,69,0,112
6837071286.jpg,0,3,46,52,1,102
6837228368.jpg,0,2,48,56,2,108
6837388142.jpg,0,13,74,20,0,107
6837541080.jpg,0,1,36,64,5,106
6837662382.jpg,0,0,36,66,2,104
6837956899.jpg,3,15,53,32,1,104
6838263860.jpg,4,49,47,4,0,104
6840130023.jpg,0,1,43,58,4,106
6840500976.jpg,0,7,66,28,1,102
6840900400.jpg,0,1,35,66,3,105
6841095.jpg,9,79,14,0,0,102
6842318096.jpg,0,1,55,50,1,107
6842750557.jpg,15,74,20,1,0,110
6843523713.jpg,1,19,62,25,1,108
6843525285.jpg,0,2,51,74,2,129
6844145276.jpg,0,0,33,67,7,107
6844398521.jpg,0,11,68,28,1,108
6844773508.jpg,0,1,34,69,1,105
6845434524.jpg,0,2,42,66,0,110
6845552547.jpg,0,6,65,28,0,99
6845847924.jpg,1,40,60,3,0,104
6845848072.jpg,0,2,28,77,4,111
6846284796.jpg,1,1,60,39,1,102
6846869922.jpg,0,5,53,49,2,109
6849285524.jpg,19,69,17,1,0,106
6849557935.jpg,33,61,17,0,0,111
6849693569.jpg,0,2,40,62,2,106
6850513360.jpg,0,0,37,105,2,144
6851326367.jpg,4,40,56,8,0,108
6853001361.jpg,0,2,33,72,1,108
6854146276.jpg,0,2,35,64,2,103
6854228547.jpg,0,7,78,25,0,110
6855935825.jpg,0,0,38,68,4,110
6856483689.jpg,0,13,72,17,1,103
6857581314.jpg,0,3,62,34,2,101
6858600475.jpg,1,9,72,24,0,106
6860404399.jpg,1,50,54,3,0,108
6860502754.jpg,4,54,41,3,0,102
68605475.jpg,0,40,53,12,0,105
6860584767.jpg,0,0,22,77,3,102
6862937532.jpg,0,13,70,27,0,110
6862989864.jpg,0,2,30,73,0,105
6864569694.jpg,0,2,62,37,2,103
6865288108.jpg,0,1,50,57,3,111
6865774865.jpg,0,4,47,54,2,107
6866519003.jpg,0,3,47,46,0,96
6866899862.jpg,0,6,64,32,1,103
6867407079.jpg,1,29,72,5,0,107
6869357574.jpg,0,43,61,4,0,108
6869450975.jpg,3,32,66,10,0,111
6869642911.jpg,0,6,48,55,2,111
6869855884.jpg,6,72,47,0,0,125
6870048801.jpg,0,0,37,66,3,106
6870564661.jpg,0,5,52,44,2,103
6870596537.jpg,0,13,69,20,0,102
6870782384.jpg,0,8,42,52,5,107
6873503299.jpg,2,42,64,7,0,115
6873701210.jpg,0,12,51,36,2,101
6874497596.jpg,3,41,49,7,0,100
6874966846.jpg,1,1,44,59,0,105
6875112664.jpg,0,4,91,30,0,125
6875194504.jpg,0,19,111,12,1,143
6875495692.jpg,0,16,67,22,0,105
6877203986.jpg,0,4,58,47,0,109
6879970399.jpg,0,38,64,1,0,103
6880912844.jpg,0,3,57,40,3,103
6880980024.jpg,12,69,19,2,0,102
688110993.jpg,0,0,41,59,1,101
6881321836.jpg,44,82,13,0,0,139
6881599127.jpg,0,4,37,54,6,101
6882017804.jpg,1,33,58,14,0,106
6883091790.jpg,0,8,81,17,0,106
6883445766.jpg,1,9,65,27,1,103
6884968602.jpg,3,69,37,1,0,110
6886226928.jpg,0,4,46,55,2,107
6886337587.jpg,0,5,64,36,0,105
6887917604.jpg,4,30,67,5,0,106
6890326436.jpg,0,5,62,37,1,105
6890378940.jpg,0,1,33,62,5,101
6890379430.jpg,0,8,65,39,1,113
6890554826.jpg,8,58,39,2,0,107
6890677809.jpg,0,0,14,75,12,101
6891271025.jpg,0,0,17,83,5,105
6891596982.jpg,0,5,67,31,1,104
6891599340.jpg,0,5,65,34,1,105
6891623153.jpg,1,8,76,19,0,104
6891957010.jpg,1,2,40,61,2,106
6892058753.jpg,0,2,42,61,3,108
6892553923.jpg,1,28,67,10,0,106
6892713466.jpg,0,1,17,74,9,101
6893014325.jpg,0,0,28,74,3,105
6893891182.jpg,3,42,55,11,0,111
6893965047.jpg,2,58,80,2,0,142
6895353221.jpg,1,32,83,6,0,122
6895365088.jpg,0,2,43,59,2,106
6896225625.jpg,0,5,64,37,1,107
6897314758.jpg,0,2,41,58,2,103
6897446719.jpg,3,67,38,4,0,112
6897675527.jpg,0,14,120,20,0,154
6898490953.jpg,0,1,13,76,15,105
6898804586.jpg,2,69,25,3,0,99
6899120807.jpg,2,7,53,41,2,105
6899517653.jpg,0,1,40,65,3,109
6899882301.jpg,0,23,78,9,0,110
6900924910.jpg,0,0,52,54,2,108
6901970679.jpg,0,12,69,23,1,105
6902342114.jpg,1,32,67,7,0,107
6902428631.jpg,0,0,45,60,1,106
6902444479.jpg,0,0,42,61,2,105
6903329459.jpg,4,86,23,0,0,113
6903462833.jpg,1,8,60,37,0,106
6903802628.jpg,0,6,65,32,1,104
6904448359.jpg,0,10,72,24,0,106
6904500540.jpg,0,1,41,84,1,127
6904675638.jpg,0,41,57,2,0,100
6905163828.jpg,0,1,44,61,1,107
6905574433.jpg,2,41,60,4,0,107
6905808386.jpg,0,7,62,31,0,100
6905924906.jpg,0,2,67,33,1,103
6906058795.jpg,0,14,53,38,1,106
6906948754.jpg,0,2,33,72,1,108
6907198605.jpg,0,1,60,41,1,103
6907499876.jpg,0,2,49,53,3,107
6907897085.jpg,0,2,36,55,4,97
6908276949.jpg,0,1,57,49,0,107
6908900076.jpg,0,0,16,79,9,104
6909297506.jpg,0,29,85,18,0,132
6909401846.jpg,0,5,38,51,11,105
6909860315.jpg,0,4,63,37,2,106
6910469420.jpg,0,4,58,69,3,134
6911254247.jpg,0,2,46,48,6,102
6911586648.jpg,8,69,24,0,0,101
6912813329.jpg,0,1,38,66,3,108
6913622130.jpg,0,0,50,54,2,106
6913908117.jpg,2,26,69,8,0,105
6915315864.jpg,0,0,45,57,0,102
6915332491.jpg,0,1,22,71,13,107
6915781600.jpg,0,1,27,71,5,104
69161613.jpg,0,3,32,65,4,104
6916511144.jpg,0,0,37,61,5,103
6918766149.jpg,0,11,70,23,0,104
691940284.jpg,0,3,39,60,2,104
6920118996.jpg,0,1,60,41,0,102
6920447844.jpg,1,2,49,66,0,118
6921149341.jpg,0,18,71,15,0,104
6921873872.jpg,2,62,38,1,0,103
6922435153.jpg,0,5,51,48,0,104
6923520196.jpg,1,78,26,1,0,106
6924377004.jpg,0,0,47,52,1,100
6926235386.jpg,0,4,64,27,1,96
6927606175.jpg,0,0,29,75,6,110
6927641976.jpg,3,47,41,12,0,103
6927744497.jpg,0,0,11,80,10,101
6928560176.jpg,1,18,74,13,0,106
6929188980.jpg,0,5,40,61,1,107
6929191226.jpg,2,32,58,11,0,103
6929201627.jpg,0,3,71,33,0,107
6930075142.jpg,0,32,60,13,0,105
6931269556.jpg,0,6,70,33,0,109
6931553873.jpg,0,1,29,69,4,103
6932651943.jpg,2,38,61,5,0,106
6933526580.jpg,0,8,56,46,1,111
6934705817.jpg,0,22,77,14,0,113
6935047173.jpg,0,0,31,65,10,106
6935129773.jpg,0,0,18,85,7,110
6935202616.jpg,0,31,67,1,0,99
6935219850.jpg,2,39,63,8,0,112
6935652834.jpg,5,60,44,1,0,110
6936616730.jpg,0,23,60,22,1,106
6936925429.jpg,0,23,66,15,0,104
6937167103.jpg,0,0,10,82,10,102
6937606166.jpg,0,0,30,75,3,108
6937691669.jpg,0,0,16,85,4,105
6937719329.jpg,0,2,51,53,0,106
6938468092.jpg,0,5,56,34,0,95
6938575813.jpg,0,2,74,30,0,106
6938775083.jpg,0,29,68,5,0,102
6938815179.jpg,0,9,73,23,0,105
6939374638.jpg,0,8,63,36,1,108
6940202479.jpg,0,2,56,45,0,103
6940429128.jpg,2,53,45,1,0,101
6941715715.jpg,0,4,63,41,1,109
6942312836.jpg,0,1,28,74,3,106
6942418274.jpg,1,16,77,13,0,107
6942738260.jpg,0,5,59,42,1,107
6943168420.jpg,0,7,67,28,1,103
6943468904.jpg,0,71,41,0,0,112
6945167278.jpg,0,2,48,57,1,108
6945246052.jpg,0,3,41,92,5,141
6945819872.jpg,0,12,69,28,0,109
6946044735.jpg,0,49,54,7,0,110
6946130339.jpg,0,1,50,52,3,106
6946374385.jpg,0,26,73,7,0,106
6947149263.jpg,0,25,69,7,0,101
6947720174.jpg,1,11,77,16,1,106
6947747616.jpg,0,3,78,24,1,106
6948272719.jpg,1,52,46,2,0,101
6949001721.jpg,1,22,68,16,1,108
6951573031.jpg,1,35,61,9,0,106
6952277665.jpg,0,22,76,6,0,104
6952458517.jpg,5,18,57,28,2,110
6953798231.jpg,0,30,57,12,0,99
6954316003.jpg,0,5,69,29,4,107
6954547933.jpg,3,58,36,3,0,100
6955151884.jpg,4,65,38,3,0,110
6955490571.jpg,0,0,34,64,3,101
6956011813.jpg,2,27,64,6,0,99
6956670735.jpg,0,20,69,18,0,107
6956736634.jpg,0,0,32,69,7,108
6957057987.jpg,0,11,58,35,0,104
6957283590.jpg,0,45,57,4,0,106
6958947570.jpg,0,3,48,51,0,102
6959482720.jpg,0,1,26,79,3,109
6960806686.jpg,0,2,71,32,0,105
6961079357.jpg,0,18,64,19,1,102
6961812492.jpg,0,5,62,38,0,105
6962031247.jpg,2,51,44,1,0,98
6962153786.jpg,0,4,32,60,8,104
6962529393.jpg,0,6,73,24,0,103
6963387147.jpg,0,20,63,18,0,101
6963905428.jpg,0,0,27,74,7,108
6965249888.jpg,0,0,47,48,2,97
6965585396.jpg,0,24,65,13,0,102
6965747606.jpg,0,1,11,89,4,105
6966361719.jpg,0,1,36,60,4,101
6966432732.jpg,0,2,41,60,2,105
6966682968.jpg,0,23,68,13,0,104
6966797840.jpg,3,48,44,4,1,100
6966908551.jpg,0,13,54,34,1,102
6967399980.jpg,0,2,34,62,7,105
6967934649.jpg,0,1,36,59,2,98
6968409021.jpg,0,18,62,29,0,109
6970549872.jpg,0,6,55,34,1,96
697114350.jpg,2,26,63,18,0,109
6972495879.jpg,0,0,16,75,11,102
6974364233.jpg,0,1,41,58,0,100
6974453710.jpg,1,25,64,11,0,101
6974573719.jpg,0,2,32,66,2,102
6974731766.jpg,8,47,46,2,0,103
6974976461.jpg,0,4,61,40,2,107
69754716.jpg,0,8,46,41,6,101
6976429442.jpg,4,54,43,1,0,102
6976437867.jpg,0,1,41,67,2,111
6976768402.jpg,0,10,74,23,1,108
6977310046.jpg,7,87,18,0,0,112
6977491270.jpg,0,0,44,60,1,105
6977554463.jpg,1,39,63,4,0,107
6978488118.jpg,0,2,22,83,6,113
6978598944.jpg,0,5,45,55,0,105
6978651748.jpg,0,0,44,65,1,110
6978738588.jpg,0,0,34,67,4,105
6979363295.jpg,0,0,56,43,3,102
6979435146.jpg,0,0,14,85,3,102
6979944704.jpg,0,0,31,75,2,108
6980009998.jpg,0,8,66,33,1,108
6980277214.jpg,0,9,61,35,0,105
6981062336.jpg,0,0,28,76,5,109
6983458217.jpg,0,3,59,36,2,100
6983491967.jpg,0,1,31,63,7,102
6983896045.jpg,0,9,64,31,2,106
6985836315.jpg,1,41,61,3,0,106
6985846441.jpg,0,9,64,28,2,103
6986641462.jpg,0,0,33,70,9,112
6986935908.jpg,0,0,48,53,2,103
6988183211.jpg,0,4,57,47,0,108
6988927721.jpg,0,0,11,85,12,108
6989772902.jpg,56,47,3,0,0,106
6991133333.jpg,0,3,71,33,0,107
6992326754.jpg,0,5,73,20,0,98
6992423707.jpg,0,3,48,53,0,104
6993179262.jpg,9,58,42,1,0,110
6993355605.jpg,0,3,60,47,0,110
6993500769.jpg,5,64,40,2,0,111
6993655335.jpg,0,0,17,72,15,104
6993723329.jpg,0,4,45,51,3,103
6994291070.jpg,0,1,61,47,0,109
6994313445.jpg,0,0,17,80,8,105
6994871976.jpg,0,2,63,34,2,101
6995068299.jpg,0,4,77,48,0,129
6995599343.jpg,0,3,58,46,0,107
6996086039.jpg,6,37,61,8,0,112
6996264658.jpg,0,5,69,32,0,106
6996280620.jpg,0,46,57,7,0,110
6997098854.jpg,0,13,76,13,0,102
6997268609.jpg,8,69,30,0,0,107
6998687310.jpg,0,11,81,18,0,110
6998702838.jpg,0,3,67,35,2,107
6999906899.jpg,0,0,41,56,3,100
7000580898.jpg,0,0,5,79,18,102
7000869677.jpg,0,1,23,76,1,101
7001480005.jpg,0,6,72,23,1,102
7001539761.jpg,0,0,19,84,4,107
7001822108.jpg,0,0,35,62,7,104
7002011797.jpg,0,3,48,47,1,99
7003526811.jpg,0,1,46,54,4,105
7003816113.jpg,44,61,3,0,0,108
7003924615.jpg,2,28,73,5,0,108
7004025487.jpg,32,96,21,0,0,149
7004286982.jpg,0,1,36,85,5,127
7004557180.jpg,0,2,46,52,3,103
7004597260.jpg,0,1,40,66,5,112
7005072091.jpg,48,53,1,1,0,103
7005136305.jpg,0,0,29,84,1,114
7005253045.jpg,1,24,65,17,0,107
7005672625.jpg,0,4,54,43,1,102
7005727843.jpg,0,2,48,50,5,105
7005951474.jpg,4,36,56,9,0,105
7005989775.jpg,2,62,43,1,0,108
7006026095.jpg,0,2,80,23,0,105
7006133071.jpg,0,2,49,52,3,106
7006191446.jpg,0,16,71,19,0,106
7006279642.jpg,0,12,75,13,0,100
7006866482.jpg,0,1,37,67,1,106
7007091368.jpg,0,1,62,41,3,107
701112732.jpg,1,15,70,18,0,104
7011343645.jpg,0,0,50,60,2,112
7011511225.jpg,0,2,41,58,3,104
7013076503.jpg,0,1,71,34,1,107
7013643069.jpg,1,35,65,3,0,104
7016006231.jpg,0,0,35,63,10,108
70164643.jpg,0,4,26,63,6,99
7017996705.jpg,0,8,102,29,0,139
7019402255.jpg,1,2,43,55,2,103
7019640975.jpg,1,0,22,80,5,108
7021084115.jpg,0,2,35,84,4,125
7021793877.jpg,0,6,70,24,1,101
7023249423.jpg,1,45,57,6,0,109
7023852485.jpg,0,3,64,32,0,99
7024265149.jpg,1,44,55,5,0,105
7024308197.jpg,0,5,83,34,0,122
7024488001.jpg,0,0,30,73,4,107
7024783845.jpg,0,32,69,7,0,108
7025630527.jpg,0,2,60,38,0,100
70272233.jpg,47,44,7,1,0,99
7029108053.jpg,0,0,19,86,1,106
7032481793.jpg,44,55,9,0,0,108
7033122257.jpg,0,11,81,13,0,105
7033769199.jpg,0,21,74,13,0,108
7035194341.jpg,0,1,27,71,6,105
7035272289.jpg,0,0,35,64,4,103
7036262065.jpg,0,0,44,60,1,105
7038478039.jpg,1,19,65,18,0,103
7038768335.jpg,0,7,54,42,1,104
7041776879.jpg,2,20,58,22,1,103
7042014185.jpg,0,1,79,31,0,111
7043681927.jpg,0,2,47,61,0,110
7043958029.jpg,0,4,80,60,0,144
7046294773.jpg,0,1,38,68,3,110
7046586351.jpg,1,23,47,34,1,106
7046617755.jpg,0,13,84,6,0,103
7046797651.jpg,0,11,69,27,0,107
7047135125.jpg,1,16,61,27,1,106
7048841203.jpg,0,1,28,64,7,100
7051563883.jpg,0,12,68,26,1,107
7052391619.jpg,0,0,35,64,5,104
7052971473.jpg,0,1,39,64,2,106
7054584681.jpg,1,3,50,50,1,105
7054855385.jpg,1,51,51,1,0,104
7055216867.jpg,0,2,38,71,0,111
7055266351.jpg,0,0,30,71,6,107
7056790837.jpg,0,3,41,58,2,104
7057320569.jpg,0,5,41,59,0,105
7058304697.jpg,0,1,53,65,4,123
7059458199.jpg,1,31,68,11,0,111
7061755895.jpg,0,0,17,77,8,102
7063010793.jpg,0,2,38,63,1,104
7063436849.jpg,0,14,54,27,1,96
706409343.jpg,0,2,30,66,3,101
7064847959.jpg,73,36,5,0,0,114
7066508685.jpg,0,14,73,11,0,98
7066539033.jpg,0,0,44,65,2,111
7071306923.jpg,0,9,69,29,0,107
7072303767.jpg,0,24,67,13,0,104
7072533905.jpg,0,0,34,65,3,102
7075654171.jpg,0,1,46,60,2,109
7076980511.jpg,0,8,56,42,2,108
7077356639.jpg,0,1,37,61,4,103
7078293355.jpg,0,0,20,68,17,105
7081444391.jpg,0,0,45,55,2,102
7082408177.jpg,1,27,65,9,0,102
7084961757.jpg,0,5,57,40,2,104
7085413157.jpg,0,6,46,45,0,97
7085880797.jpg,0,5,57,41,0,103
7085959839.jpg,1,9,67,32,1,110
7087645993.jpg,0,2,50,57,1,110
7089392359.jpg,0,1,31,70,3,105
7090447613.jpg,1,20,69,14,0,104
7092360919.jpg,0,26,66,13,0,105
7092910349.jpg,0,12,70,24,1,107
7094182327.jpg,0,18,76,10,1,105
7095677109.jpg,4,75,22,2,0,103
7096133531.jpg,1,5,70,51,0,127
7096952113.jpg,0,8,65,32,1,106
7100857351.jpg,0,2,30,65,4,101
7102405013.jpg,0,2,60,38,2,102
7102475637.jpg,1,4,59,37,1,102
7102713545.jpg,0,1,52,48,1,102
7102805935.jpg,0,0,35,73,2,110
7104640807.jpg,0,1,43,55,0,99
7105123297.jpg,2,19,48,38,3,110
7106381255.jpg,73,29,0,0,0,102
7107776883.jpg,2,14,68,21,1,106
7107867443.jpg,2,32,61,12,0,107
7108939139.jpg,0,0,12,86,11,109
7109803877.jpg,0,5,38,63,3,109
7109981551.jpg,0,3,66,37,2,108
7110105161.jpg,1,31,67,7,0,106
7111226249.jpg,0,0,52,60,1,113
7112366827.jpg,0,3,45,50,5,103
7113461019.jpg,2,23,96,11,0,132
7113653815.jpg,0,1,35,74,4,114
7116112855.jpg,3,11,74,20,0,108
7119041313.jpg,0,2,40,63,3,108
7119860187.jpg,0,0,43,64,1,108
7122976485.jpg,0,0,27,71,5,103
7123405099.jpg,0,12,65,29,0,106
7123410119.jpg,0,0,24,77,6,107
7124206301.jpg,8,72,22,3,0,105
7125445143.jpg,0,6,49,46,2,103
7125596297.jpg,0,4,40,57,11,112
7130276433.jpg,0,13,76,17,0,106
7131604965.jpg,0,9,64,24,0,97
7131772191.jpg,0,1,25,70,4,100
7131884003.jpg,0,4,69,37,1,111
7132841089.jpg,0,2,33,70,4,109
7134278631.jpg,0,3,66,41,1,111
7135099747.jpg,0,1,28,68,2,99
7136073057.jpg,0,6,66,30,0,102
7138669275.jpg,0,17,59,27,0,103
7141084967.jpg,0,4,56,42,3,105
7141864663.jpg,0,13,70,18,0,101
7143312581.jpg,0,7,77,16,0,100
7144832397.jpg,0,5,48,53,1,107
71458295.jpg,0,6,52,46,0,104
7146833457.jpg,0,34,63,6,0,103
7148484633.jpg,0,9,63,37,0,109
7148644865.jpg,0,1,45,62,1,109
7149494135.jpg,0,2,38,63,4,107
7149994451.jpg,1,9,57,36,4,107
7152554103.jpg,0,1,29,73,2,105
7154088130.jpg,1,2,32,69,3,107
7154960969.jpg,0,15,77,16,0,108
7155826261.jpg,0,5,49,49,1,104
7157345124.jpg,0,4,59,46,1,110
7158075991.jpg,0,2,33,61,7,103
7158901982.jpg,0,10,56,35,2,103
7159650647.jpg,0,30,90,8,0,128
7160553409.jpg,0,1,69,58,1,129
7161322897.jpg,0,2,49,48,1,100
7162655.jpg,0,6,45,40,11,102
7162678728.jpg,0,4,84,39,1,128
7162855925.jpg,63,42,2,0,0,107
7163084628.jpg,0,1,19,77,6,103
7163375274.jpg,0,1,46,55,3,105
7164723575.jpg,0,5,64,38,1,108
7165207702.jpg,0,4,55,50,2,111
7165704390.jpg,0,0,32,68,3,103
7166012405.jpg,0,12,71,23,1,107
7167005638.jpg,4,77,18,1,0,100
7167167089.jpg,0,6,57,36,0,99
7167430526.jpg,0,2,56,44,1,103
7167513416.jpg,0,0,26,69,17,112
7167608916.jpg,0,3,46,54,2,105
7167671368.jpg,0,3,65,40,0,108
7168526408.jpg,0,2,57,38,2,99
7168884193.jpg,0,0,34,66,6,106
7169239087.jpg,0,0,14,92,5,111
7169475537.jpg,0,1,14,80,6,101
7169652147.jpg,0,3,64,43,1,111
7170927811.jpg,3,46,55,2,0,106
7171867098.jpg,1,1,35,59,5,101
7172192793.jpg,0,20,78,11,0,109
7172324016.jpg,0,25,63,14,0,102
7173122782.jpg,1,48,46,7,0,102
7173197243.jpg,0,0,27,81,1,109
7173633933.jpg,8,61,34,2,0,105
7175697564.jpg,1,0,42,64,4,111
7175721471.jpg,0,5,71,80,0,156
7176672187.jpg,0,7,75,28,0,110
71775760.jpg,2,38,57,8,0,105
7178199774.jpg,0,0,12,82,9,103
7178723916.jpg,0,31,66,12,0,109
7179150708.jpg,0,4,70,33,0,107
7179426262.jpg,0,2,57,42,0,101
7179446780.jpg,0,2,54,49,0,105
7180497616.jpg,0,20,59,29,0,108
7181156093.jpg,2,31,59,13,0,105
7181400642.jpg,1,45,52,5,0,103
7182538268.jpg,0,0,24,79,2,105
7183220075.jpg,0,0,12,87,11,110
7185825441.jpg,2,50,62,0,0,114
7186435015.jpg,0,0,26,71,9,106
7186783534.jpg,0,23,67,17,0,107
7188136873.jpg,1,26,69,11,0,107
7188151253.jpg,3,57,41,3,0,104
7188153176.jpg,0,31,80,15,0,126
7188178353.jpg,0,19,65,15,0,99
7189264298.jpg,0,0,20,72,13,105
7189498789.jpg,0,8,46,42,5,101
7189997672.jpg,0,1,43,56,1,101
7191194360.jpg,1,28,56,13,1,99
7192279956.jpg,0,1,64,40,0,105
7192501662.jpg,0,1,51,47,3,102
7192785398.jpg,1,15,74,21,0,111
7194253160.jpg,0,0,33,73,1,107
7194624166.jpg,0,1,23,74,9,107
7194820358.jpg,0,1,16,87,3,107
7196174704.jpg,0,16,70,15,0,101
7196416584.jpg,0,14,75,19,0,108
7200434768.jpg,0,6,84,43,0,133
7202630536.jpg,0,4,39,60,0,103
7202661434.jpg,0,0,46,59,2,107
7203007382.jpg,0,60,46,1,0,107
7203013446.jpg,0,8,73,23,0,104
7203865570.jpg,0,0,24,82,0,106
7212441932.jpg,0,6,63,36,0,105
7213266604.jpg,0,7,76,26,0,109
7214387770.jpg,0,2,29,80,1,112
7214440922.jpg,1,6,61,36,3,107
7214629206.jpg,0,2,56,46,0,104
7215678842.jpg,0,0,29,78,4,111
7217797182.jpg,0,4,71,32,0,107
7219282312.jpg,0,15,75,18,1,109
7219295732.jpg,1,37,59,4,0,101
7222616846.jpg,0,1,24,78,5,108
7222733996.jpg,0,0,24,73,3,100
7223815722.jpg,0,4,47,56,0,107
7224064916.jpg,0,2,40,59,1,102
7225479532.jpg,0,10,63,32,1,106
7228274052.jpg,0,2,37,55,4,98
7229767436.jpg,0,0,43,54,4,101
7230853930.jpg,0,1,37,62,2,102
7232368208.jpg,0,9,65,26,2,102
7232875546.jpg,0,1,55,44,4,104
7233783308.jpg,0,9,51,46,1,107
7236084356.jpg,0,0,22,79,5,106
7238368946.jpg,7,62,35,7,0,111
7238571992.jpg,0,2,35,61,0,98
7238585598.jpg,0,1,59,43,1,104
7238696504.jpg,0,9,82,15,1,107
7240407408.jpg,1,4,55,49,1,110
7241141390.jpg,30,70,11,1,0,112
7242888546.jpg,0,21,71,8,0,100
7247521810.jpg,12,63,29,8,0,112
7249502132.jpg,0,3,50,43,2,98
7250719968.jpg,0,0,27,77,2,106
7250885308.jpg,0,3,45,52,4,104
7252678814.jpg,0,0,27,61,14,102
7253127574.jpg,0,1,46,57,3,107
7253262358.jpg,2,31,68,9,0,110
7253541416.jpg,0,2,51,83,1,137
7255289130.jpg,0,1,24,74,3,102
7255559908.jpg,0,0,16,72,19,107
7259290306.jpg,0,7,69,23,1,100
7259325322.jpg,0,7,68,32,1,108
7259602320.jpg,0,7,71,26,0,104
7259699596.jpg,0,14,78,14,0,106
7260057636.jpg,0,5,55,46,0,106
7260432838.jpg,0,1,56,45,2,104
7260489840.jpg,0,2,37,65,1,105
7262794678.jpg,0,3,32,72,3,110
7262954956.jpg,0,1,28,72,4,105
7263783306.jpg,3,43,57,2,0,105
7264008364.jpg,0,0,32,65,8,105
7264923790.jpg,0,0,20,85,8,113
7264968696.jpg,0,2,44,54,3,103
7265767786.jpg,0,1,44,85,3,133
7265792384.jpg,2,23,67,13,0,105
7266979612.jpg,0,2,54,48,1,105
7267070590.jpg,7,64,28,3,0,102
7267396470.jpg,0,30,69,8,0,107
7268649826.jpg,0,1,50,49,0,100
7268981578.jpg,6,59,39,2,0,106
7269352924.jpg,0,10,71,24,0,105
7269365920.jpg,0,7,73,67,3,150
7270304334.jpg,17,83,6,1,0,107
7270764894.jpg,0,1,46,53,5,105
7270896820.jpg,0,5,47,52,0,104
7271105620.jpg,0,1,19,77,8,105
7272392080.jpg,0,0,34,66,1,101
7272599674.jpg,0,31,72,5,0,108
7275267386.jpg,1,30,70,6,0,107
7276071932.jpg,0,0,10,85,15,110
7276321940.jpg,1,46,51,3,0,101
7276446104.jpg,0,1,46,63,0,110
7276523780.jpg,0,1,29,74,1,105
7277660018.jpg,0,1,38,64,3,106
7280314854.jpg,1,18,64,21,0,104
7280808920.jpg,0,1,25,76,6,108
7281146720.jpg,0,0,30,67,5,102
7283094026.jpg,0,4,23,60,18,105
7285012394.jpg,0,3,58,48,1,110
7286003056.jpg,0,2,44,56,0,102
7287141628.jpg,0,2,52,50,0,104
7287423330.jpg,0,2,42,65,3,112
7288043746.jpg,2,65,86,2,0,155
7288524676.jpg,0,8,54,44,2,108
7289957138.jpg,2,16,85,24,0,127
7291000146.jpg,1,2,57,52,1,113
7292757116.jpg,0,1,15,80,6,102
7292878318.jpg,0,4,66,33,0,103
7295291032.jpg,0,5,44,59,1,109
7295363820.jpg,7,13,40,38,4,102
7296337218.jpg,0,4,58,39,0,101
7297259404.jpg,0,7,57,45,0,109
7297786732.jpg,0,2,55,53,0,110
7300513490.jpg,0,7,72,23,1,103
7300766830.jpg,1,9,60,35,0,105
7301944302.jpg,0,6,60,37,1,104
7303073674.jpg,0,1,19,79,7,106
7303973886.jpg,0,6,54,45,0,105
7304709380.jpg,0,3,29,72,3,107
7305940242.jpg,0,1,40,60,1,102
7310636810.jpg,0,1,36,64,3,104
7312266068.jpg,0,20,71,18,0,109
7312752876.jpg,1,25,62,19,1,108
7316131560.jpg,0,0,35,64,4,103
7316218852.jpg,2,23,70,9,0,104
7316593310.jpg,0,1,26,72,5,104
7316816362.jpg,0,26,115,11,0,152
7317766722.jpg,0,0,38,63,2,103
7318578602.jpg,0,2,32,89,3,126
7319806894.jpg,0,7,53,44,1,105
7319912164.jpg,0,3,45,52,2,102
7319984198.jpg,0,0,40,64,2,106
7321293264.jpg,2,26,60,13,1,102
7322656062.jpg,0,0,23,80,4,107
7323620090.jpg,0,3,53,47,0,103
7325916584.jpg,0,2,35,71,1,109
7328195954.jpg,0,2,39,65,2,108
7328979392.jpg,0,1,25,68,12,106
7329465526.jpg,0,0,32,91,2,125
7331539774.jpg,0,0,35,70,5,110
7331542456.jpg,0,6,46,45,4,101
7334314036.jpg,0,0,20,89,1,110
7334526272.jpg,0,2,43,62,0,107
7337709978.jpg,0,2,65,39,0,106
7337936636.jpg,0,0,21,75,14,110
7339049388.jpg,0,1,19,73,13,106
7339222496.jpg,0,2,57,40,0,99
7339227510.jpg,3,49,51,3,0,106
7339736582.jpg,0,1,53,50,4,108
7340239088.jpg,3,43,62,3,0,111
7342857520.jpg,0,20,61,15,1,97
7344897910.jpg,1,31,54,20,0,106
7348582056.jpg,0,0,50,58,3,111
7348931184.jpg,0,16,85,28,0,129
7349520418.jpg,0,22,55,28,0,105
735046558.jpg,12,78,20,0,0,110
7351425672.jpg,0,0,45,78,8,131
7352368166.jpg,0,0,47,56,5,108
7354160932.jpg,0,2,54,44,0,100
7355331384.jpg,1,1,57,46,0,105
7355344734.jpg,0,0,13,90,6,109
7355708808.jpg,0,1,56,51,1,109
73558937.jpg,0,20,51,27,2,100
7355960902.jpg,1,57,39,5,0,102
7358286276.jpg,87,24,1,0,0,112
7358753494.jpg,1,21,66,14,0,102
7359378256.jpg,0,5,40,56,2,103
7360550332.jpg,0,2,40,60,1,103
7361922724.jpg,0,1,12,84,13,110
7362254314.jpg,0,14,71,25,0,110
7365538478.jpg,0,0,31,69,3,103
7365681654.jpg,2,80,23,2,0,107
7367414528.jpg,2,21,62,20,0,105
7369136066.jpg,8,78,14,1,0,101
7369281846.jpg,0,3,58,43,0,104
7369682094.jpg,0,3,69,33,0,105
7374960236.jpg,1,15,58,33,1,108
7376214050.jpg,2,54,41,3,0,100
7376910984.jpg,0,26,72,8,0,106
7380460592.jpg,0,0,43,67,0,110
7381771262.jpg,0,8,72,32,0,112
7382035482.jpg,0,4,57,43,1,105
7382484290.jpg,3,36,60,4,0,103
7383311936.jpg,10,55,34,6,0,105
7384140824.jpg,0,0,20,64,23,107
7387717156.jpg,1,53,44,2,1,101
7388185182.jpg,0,2,52,46,1,101
7390518132.jpg,0,2,67,68,2,139
7391300046.jpg,0,3,62,39,0,104
7391334516.jpg,0,4,43,59,0,106
7391355184.jpg,0,1,20,87,3,111
7392719524.jpg,0,0,32,67,6,105
7393631040.jpg,0,0,30,75,7,112
7395359632.jpg,22,76,5,0,0,103
7399191468.jpg,1,14,74,18,0,107
7399670298.jpg,3,38,64,0,0,105
7401378600.jpg,0,0,26,73,4,103
7402614702.jpg,21,66,13,1,0,101
7405428626.jpg,1,38,68,5,0,112
7406520610.jpg,0,0,16,80,7,103
7407428670.jpg,0,5,64,32,0,101
7408729508.jpg,0,11,33,60,1,105
7411918198.jpg,3,21,66,16,0,106
7413044200.jpg,0,0,11,87,9,107
7417878338.jpg,1,0,12,85,9,107
7418763178.jpg,0,16,77,14,0,107
7419326966.jpg,0,1,30,65,3,99
7424501528.jpg,0,3,46,60,2,111
7425462410.jpg,0,0,39,70,1,110
7425526298.jpg,0,43,63,2,0,108
742801177.jpg,1,38,56,13,0,108
7431456352.jpg,2,44,54,8,1,109
7432159802.jpg,1,17,72,11,0,101
7432387258.jpg,0,3,26,70,7,106
7433488844.jpg,0,29,66,4,0,99
7434980246.jpg,0,4,53,49,0,106
7437031540.jpg,0,13,65,31,1,110
7437035640.jpg,1,19,69,19,0,108
7437582530.jpg,0,5,63,29,1,98
7442226424.jpg,1,20,74,15,0,110
7442324444.jpg,1,5,69,30,0,105
7442416994.jpg,0,1,25,77,3,106
7442925808.jpg,0,0,13,84,9,106
7443145706.jpg,0,0,23,83,4,110
7443887988.jpg,40,59,11,2,0,112
7445548804.jpg,0,16,75,12,0,103
7445572890.jpg,0,0,18,78,5,101
7445811974.jpg,0,5,33,73,2,113
7448603724.jpg,0,0,30,75,4,109
7448606010.jpg,0,30,63,13,0,106
7452245552.jpg,9,66,21,4,0,100
7452954268.jpg,0,1,33,75,3,112
7455132680.jpg,1,10,62,31,2,106
7455819414.jpg,0,2,63,35,0,100
7459333336.jpg,0,2,26,62,10,100
7459539092.jpg,0,1,60,47,0,108
7459547170.jpg,0,3,61,43,1,108
7460005346.jpg,0,9,64,36,1,110
7460698156.jpg,0,0,38,61,6,105
7461279878.jpg,0,4,64,32,0,100
7461618822.jpg,1,8,78,31,1,119
7463764592.jpg,0,0,18,85,4,107
7465586874.jpg,0,1,65,37,2,105
7466229858.jpg,0,6,52,48,0,106
7466614786.jpg,0,0,32,70,5,107
7467164130.jpg,3,17,37,46,0,103
7468704128.jpg,0,0,17,85,11,113
7470410498.jpg,0,12,62,27,2,103
7470463166.jpg,0,0,42,66,0,108
7470692282.jpg,2,40,52,8,0,102
7470832570.jpg,0,5,65,31,2,103
7472436450.jpg,17,73,13,0,0,103
7473958436.jpg,0,2,16,74,8,100
7478826230.jpg,0,2,74,50,0,126
7480977716.jpg,0,12,75,16,0,103
7483507340.jpg,6,60,43,4,0,113
7484588674.jpg,0,4,52,44,4,104
7485150056.jpg,0,2,76,29,0,107
7488642130.jpg,0,6,50,53,0,109
7490518604.jpg,0,3,55,34,2,94
7490651104.jpg,0,2,43,55,2,102
7490674084.jpg,0,2,50,48,2,102
7491724488.jpg,0,2,47,51,1,101
7491939464.jpg,0,22,57,30,1,110
7492007796.jpg,1,19,53,25,0,98
7492033480.jpg,1,9,60,35,0,105
7493136824.jpg,7,72,24,1,0,104
7495567704.jpg,0,2,73,31,0,106
7497107258.jpg,0,12,86,8,0,106
7499578096.jpg,0,15,80,10,0,105
7499781424.jpg,0,1,43,59,2,105
7502944264.jpg,0,1,37,66,5,109
7504569144.jpg,0,0,41,63,1,105
7504875900.jpg,13,83,12,1,0,109
7505379000.jpg,1,18,56,30,0,105
7505926112.jpg,0,6,59,44,0,109
7506629916.jpg,4,34,53,8,0,99
7506684932.jpg,0,2,27,68,6,103
7510638426.jpg,3,17,59,25,1,105
7510743692.jpg,0,7,56,42,1,106
7512526314.jpg,0,14,48,44,1,107
751468322.jpg,12,82,17,0,0,111
7517892652.jpg,0,25,58,22,1,106
7519024248.jpg,0,0,52,49,2,103
7519982836.jpg,0,3,38,65,0,106
7520058110.jpg,0,2,57,39,1,99
7520824760.jpg,0,6,80,44,1,131
7525316320.jpg,0,5,72,24,0,101
7525406860.jpg,1,11,53,37,2,104
7526135750.jpg,0,25,67,15,0,107
7526349354.jpg,1,73,52,2,0,128
7530928692.jpg,1,49,45,8,0,103
7530958636.jpg,0,7,60,35,6,108
7533737270.jpg,0,0,14,72,22,108
7535091270.jpg,1,2,51,47,0,101
7537722246.jpg,1,4,49,46,1,101
7538144396.jpg,0,7,87,16,0,110
7538254742.jpg,0,16,72,15,1,104
7538834488.jpg,0,1,45,52,1,99
7539744490.jpg,0,8,65,31,0,104
7543000548.jpg,0,0,49,59,3,111
7543397674.jpg,1,20,69,9,0,99
7543713322.jpg,0,0,47,58,1,106
7548332064.jpg,3,44,56,2,0,105
7550549938.jpg,0,6,38,57,2,103
7551562932.jpg,1,41,55,1,0,98
7553660370.jpg,0,13,66,31,0,110
7555167080.jpg,0,3,63,41,1,108
7555880012.jpg,0,32,73,5,0,110
7556722466.jpg,0,1,84,21,0,106
7557808298.jpg,0,0,29,72,1,102
7559495698.jpg,38,68,5,0,0,111
7561653238.jpg,0,1,39,57,4,101
7561935496.jpg,0,1,33,64,3,101
7562246986.jpg,2,36,60,8,1,107
7568401328.jpg,0,3,58,42,1,104
7569119428.jpg,1,4,42,50,10,107
7570426860.jpg,0,0,36,65,6,107
7571378378.jpg,0,10,79,11,1,101
7571885930.jpg,0,0,21,73,9,103
7572752818.jpg,0,5,49,44,1,99
7574036406.jpg,0,43,58,5,0,106
7574416384.jpg,0,0,5,75,23,103
7575998494.jpg,0,3,51,54,1,109
7577281784.jpg,0,5,55,49,0,109
7578229060.jpg,0,0,28,87,6,121
7579253532.jpg,0,23,73,17,0,113
7579386834.jpg,0,15,85,20,1,121
7581184960.jpg,0,2,62,40,1,105
7582497202.jpg,0,7,55,45,1,108
7583515.jpg,10,71,23,3,0,107
7586142684.jpg,1,6,79,44,0,130
7586560076.jpg,0,2,52,50,1,105
7587404052.jpg,16,79,12,0,0,107
7588949536.jpg,5,72,22,0,0,99
7590781464.jpg,0,3,23,71,4,101
7591145832.jpg,0,2,35,68,4,109
7591870206.jpg,0,8,76,27,0,111
7592360042.jpg,0,5,56,33,2,96
7593868958.jpg,0,6,64,38,0,108
7597470314.jpg,0,14,78,12,0,104
7603371702.jpg,0,2,30,76,3,111
7605930400.jpg,0,2,39,65,1,107
7607759408.jpg,6,63,36,0,0,105
7608025600.jpg,0,0,39,58,3,100
7608257388.jpg,0,16,79,11,0,106
7613152858.jpg,0,0,27,75,5,107
7614530994.jpg,0,0,14,81,8,103
7616384942.jpg,0,1,19,77,6,103
7617788578.jpg,0,4,73,28,0,105
7617916556.jpg,0,2,44,63,1,110
7618408824.jpg,0,4,63,36,2,105
7622957154.jpg,0,0,26,83,3,112
7622984342.jpg,0,0,41,59,1,101
7625539278.jpg,4,57,39,0,0,100
762560347.jpg,0,7,78,24,0,109
7627158600.jpg,1,11,57,38,0,107
7627340946.jpg,66,36,4,0,0,106
7627752046.jpg,0,4,67,35,1,107
7628306442.jpg,4,53,48,3,0,108
7628564828.jpg,0,7,41,54,2,104
7628769918.jpg,0,1,31,67,3,102
7629156184.jpg,0,3,35,62,3,103
7630573758.jpg,2,36,66,5,0,109
763136296.jpg,0,1,34,62,4,101
7633437372.jpg,0,15,62,29,0,106
7634190334.jpg,0,1,16,80,4,101
7635858220.jpg,0,3,74,28,2,107
7636475996.jpg,20,72,9,0,0,101
7640299878.jpg,0,2,37,65,2,106
7641363622.jpg,0,6,59,43,0,108
7644640634.jpg,1,46,47,4,0,98
7645259944.jpg,3,56,49,3,1,112
764877350.jpg,1,28,47,34,0,110
7651161432.jpg,0,0,14,89,6,109
7651198192.jpg,0,8,57,45,2,112
7652900928.jpg,0,3,78,25,0,106
7654676706.jpg,0,17,76,11,1,105
7655498028.jpg,1,26,66,6,0,99
7657349694.jpg,1,24,66,6,0,97
7660049550.jpg,0,3,66,41,0,110
7660271516.jpg,0,4,45,52,3,104
7660478078.jpg,0,19,60,27,2,108
7661933374.jpg,0,6,53,34,1,94
7662529090.jpg,0,7,66,36,0,109
7664231886.jpg,0,1,57,49,4,111
7665609968.jpg,0,1,45,64,0,110
7667669426.jpg,0,0,20,78,6,104
7668828488.jpg,0,1,42,59,2,104
7670929454.jpg,0,2,37,63,3,105
7671053258.jpg,0,0,30,79,2,111
7671701194.jpg,0,0,13,80,15,108
7672860636.jpg,0,16,67,23,0,106
7673637784.jpg,0,11,69,27,1,108
7673801638.jpg,0,0,13,85,3,101
7674660830.jpg,0,4,52,45,1,102
7676074992.jpg,0,9,71,23,0,103
7676832810.jpg,0,9,67,32,1,109
7678256566.jpg,0,0,15,83,6,104
7678821440.jpg,0,3,37,50,7,97
767916820.jpg,0,1,44,55,2,102
7684026832.jpg,1,16,81,15,0,113
7685277932.jpg,0,2,66,32,0,100
7685698864.jpg,0,16,97,16,0,129
7689540594.jpg,0,1,16,80,1,98
7690007638.jpg,1,13,60,28,0,102
7692418948.jpg,0,14,67,25,0,106
7693237184.jpg,0,4,43,55,5,107
7695585576.jpg,0,0,10,80,16,106
7697080640.jpg,0,1,63,46,1,111
7697492926.jpg,0,2,81,43,0,126
7700511938.jpg,0,5,68,30,0,103
7700955958.jpg,0,2,66,36,1,105
7703482662.jpg,0,5,42,52,3,102
7704019566.jpg,0,1,31,62,5,99
7705365342.jpg,0,9,58,32,0,99
7710623518.jpg,0,20,70,18,0,108
7710868262.jpg,0,13,69,20,0,102
7712722502.jpg,1,0,25,73,6,105
7714207710.jpg,4,72,57,2,0,135
7714653298.jpg,2,34,65,4,0,105
7715219180.jpg,1,29,62,9,0,101
7717158358.jpg,0,0,30,70,4,104
7720747032.jpg,0,2,23,77,8,110
7721291102.jpg,0,2,43,56,4,105
772323238.jpg,3,24,66,8,0,101
7726222874.jpg,27,69,8,0,0,104
7728661610.jpg,0,1,59,79,1,140
7728764770.jpg,0,0,32,65,2,99
7730088582.jpg,5,67,45,4,0,121
7731030916.jpg,3,46,54,6,0,109
7731352704.jpg,0,0,16,88,6,110
7731477968.jpg,12,75,16,2,0,105
7732609964.jpg,0,0,13,91,4,108
7734376776.jpg,0,0,35,68,4,107
7734540620.jpg,0,2,36,68,1,107
7736222330.jpg,0,14,67,25,0,106
7736601364.jpg,0,2,11,95,6,114
7736819994.jpg,0,13,67,32,1,113
7737023436.jpg,0,25,66,11,0,102
7737184960.jpg,0,2,65,36,1,104
7738480598.jpg,5,75,23,2,0,105
7739550292.jpg,0,12,70,20,0,102
7741343046.jpg,0,17,80,9,0,106
774152136.jpg,0,18,69,12,0,99
7743542184.jpg,0,0,20,80,6,106
7743779530.jpg,0,5,71,30,1,107
7744113492.jpg,1,20,70,14,0,105
7744189800.jpg,0,21,64,22,0,107
7744274780.jpg,0,2,52,49,1,104
7744803492.jpg,0,0,43,66,0,109
7745091164.jpg,0,0,32,65,5,102
7745366610.jpg,3,55,64,5,0,127
7748906306.jpg,0,3,49,54,1,107
7749694370.jpg,0,1,50,57,0,108
7749930286.jpg,0,0,25,72,10,107
7751327300.jpg,0,0,25,75,2,102
7751390858.jpg,1,9,69,21,0,100
7751603360.jpg,8,55,35,4,0,102
7751690228.jpg,0,0,39,59,2,100
7751952772.jpg,0,1,46,66,0,113
7753523026.jpg,0,6,73,21,1,101
7755707532.jpg,0,1,40,59,3,103
7755789428.jpg,0,4,63,35,0,102
7756416864.jpg,8,61,36,2,0,107
7756578200.jpg,39,61,9,0,0,109
7758019722.jpg,0,7,57,37,3,104
7758020806.jpg,0,1,55,45,4,105
7759565946.jpg,0,0,27,64,11,102
7762883720.jpg,0,1,44,57,1,103
7763162224.jpg,1,18,67,16,0,102
7765078282.jpg,0,2,58,43,0,103
7765809112.jpg,0,22,75,12,0,109
7766392832.jpg,17,77,13,1,0,108
7767174802.jpg,0,6,82,18,0,106
7767472114.jpg,0,3,56,45,0,104
7769931466.jpg,5,32,55,14,0,106
7769932398.jpg,0,2,46,56,4,108
7772663024.jpg,0,9,63,32,1,105
7777135010.jpg,3,62,60,3,0,128
7778203492.jpg,8,42,48,9,1,108
7780172596.jpg,0,1,37,55,4,97
7783320848.jpg,0,1,40,56,3,100
7785216770.jpg,0,5,71,25,1,102
7785223076.jpg,52,48,5,0,0,105
7786382886.jpg,0,6,65,29,0,100
7787028496.jpg,1,23,69,9,0,102
7788471088.jpg,1,19,51,32,1,104
7788745946.jpg,0,1,30,81,0,112
7789853112.jpg,0,1,32,71,7,111
7793934458.jpg,0,11,67,24,0,102
7795324248.jpg,0,2,44,60,3,109
7795515978.jpg,1,15,70,27,0,113
7796133504.jpg,0,3,40,61,1,105
7797268116.jpg,0,5,51,48,1,105
7797743908.jpg,0,2,30,68,4,104
7801382324.jpg,3,6,64,34,0,107
7802615964.jpg,0,1,47,83,1,132
7802695886.jpg,0,0,20,83,7,110
7806389418.jpg,0,1,38,60,3,102
7807631220.jpg,0,0,11,81,12,104
7809493264.jpg,0,0,22,71,10,103
7810003032.jpg,0,2,34,60,11,107
7810074740.jpg,0,1,26,62,12,101
7811282766.jpg,0,3,29,72,1,105
7811388288.jpg,14,66,30,1,0,111
7814162374.jpg,0,9,50,39,3,101
7816938468.jpg,0,16,57,37,0,110
7819211312.jpg,0,21,75,6,0,102
7819353184.jpg,0,0,26,75,1,102
7819666996.jpg,0,0,31,70,4,105
7820783548.jpg,3,37,54,7,0,101
7822391242.jpg,0,16,57,32,0,105
7823568906.jpg,0,2,51,55,0,108
7823939538.jpg,0,2,29,67,7,105
7826230260.jpg,0,7,47,52,2,108
7826703034.jpg,0,3,42,47,1,93
7832796652.jpg,0,2,29,70,6,107
7833281270.jpg,0,2,57,41,1,101
7838423662.jpg,0,2,58,45,3,108
7839484666.jpg,0,2,45,52,2,101
7840986296.jpg,0,3,39,61,2,105
7841725264.jpg,0,3,54,48,0,105
7841765362.jpg,1,1,68,64,0,134
7841859142.jpg,1,8,68,27,0,104
7841962592.jpg,0,2,46,52,3,103
7842127896.jpg,0,1,49,54,3,107
7843258130.jpg,0,0,43,61,1,105
7843358908.jpg,1,19,72,14,1,107
7843799770.jpg,0,4,50,53,4,111
7844179556.jpg,0,0,28,79,3,110
7845980046.jpg,0,0,24,71,4,99
7846766204.jpg,0,0,24,84,0,108
7850123296.jpg,1,14,68,18,1,102
7853457684.jpg,0,3,53,52,0,108
7854876374.jpg,2,16,64,30,1,113
7856175732.jpg,0,0,17,74,7,98
7856451374.jpg,0,1,47,51,2,101
7859713146.jpg,0,0,16,82,11,109
7861079240.jpg,0,2,33,72,2,109
7863241080.jpg,1,14,59,29,1,104
7866144530.jpg,0,0,25,75,3,103
7866480612.jpg,0,3,42,50,5,100
7867041724.jpg,0,0,36,68,4,108
7867646032.jpg,0,2,33,106,8,149
7868631444.jpg,0,19,70,15,0,104
7870300862.jpg,1,29,68,8,0,106
7870688128.jpg,0,9,90,56,1,156
7871237210.jpg,0,2,35,56,11,104
7871346190.jpg,0,1,36,60,4,101
7875370780.jpg,0,5,51,48,1,105
7875374202.jpg,0,1,47,57,0,105
7875422248.jpg,0,1,28,80,4,113
7877688978.jpg,0,55,47,8,0,110
7878410170.jpg,1,41,62,1,0,105
7880797072.jpg,0,17,85,7,0,109
7881174736.jpg,0,4,85,52,0,141
7883125264.jpg,3,41,44,14,0,102
7887126684.jpg,0,1,24,74,5,104
7889791504.jpg,0,6,51,45,0,102
7892040540.jpg,0,0,39,60,6,105
7892635308.jpg,0,0,37,65,2,104
7893560424.jpg,0,9,71,24,1,105
7896479602.jpg,0,1,55,43,3,102
7897296676.jpg,0,0,66,35,2,103
7899104502.jpg,4,14,58,24,0,100
7900291786.jpg,0,3,71,32,0,106
7900303150.jpg,9,59,36,1,0,105
7902540732.jpg,0,2,38,68,1,109
7903006270.jpg,0,1,27,66,12,106
7903635044.jpg,0,16,67,21,0,104
7903686666.jpg,0,6,58,33,2,99
7903714372.jpg,0,26,66,8,0,100
7904253618.jpg,0,47,51,6,0,104
7904310752.jpg,0,0,59,47,1,107
7904631250.jpg,0,0,30,79,2,111
7906332480.jpg,0,2,57,41,1,101
7908624656.jpg,0,2,15,78,7,102
7908884988.jpg,0,1,41,56,0,98
7909059554.jpg,1,12,42,52,3,110
7911339166.jpg,0,1,34,66,3,104
7911502338.jpg,0,21,75,13,0,109
7911673358.jpg,0,2,35,60,6,103
7913897946.jpg,0,10,69,28,0,107
7914158128.jpg,0,5,49,50,1,105
7914531096.jpg,0,0,25,74,5,104
7914714726.jpg,0,0,17,76,8,101
7915207374.jpg,0,19,62,20,0,101
7915889156.jpg,0,22,65,15,0,102
7917906506.jpg,0,7,70,29,0,106
7919265884.jpg,10,88,7,0,0,105
7919270808.jpg,1,59,47,1,0,108
7919700760.jpg,0,1,18,79,8,106
7920824878.jpg,0,4,58,37,0,99
7921753876.jpg,0,1,28,77,6,112
7923574034.jpg,0,14,60,37,0,111
7924068268.jpg,0,2,35,58,10,105
7924366.jpg,70,36,2,0,0,108
7926649668.jpg,0,28,63,5,0,96
7927998516.jpg,0,0,37,62,3,102
7928561010.jpg,2,51,47,6,0,106
7929212614.jpg,0,5,30,60,6,101
7929526740.jpg,0,2,32,68,5,107
7931367844.jpg,0,1,19,70,14,104
7934073070.jpg,1,24,93,11,0,129
7934781744.jpg,0,11,65,43,1,120
7935628474.jpg,0,0,19,86,6,111
7937116986.jpg,0,3,38,59,1,101
7940282852.jpg,0,38,56,6,0,100
7940912870.jpg,0,11,80,17,0,108
7942038522.jpg,0,24,51,30,0,105
7945344572.jpg,0,10,68,26,0,104
7946144914.jpg,0,22,73,17,1,113
7946380974.jpg,0,3,54,50,0,107
7946509460.jpg,0,9,97,21,0,127
7946535104.jpg,0,11,54,48,1,114
7946918290.jpg,5,70,27,2,0,104
79475896.jpg,5,35,63,2,0,105
7951947544.jpg,0,24,63,11,0,98
7954181598.jpg,0,2,56,42,2,102
7954324384.jpg,1,4,69,25,1,100
7954849148.jpg,0,1,18,80,4,103
7955276034.jpg,3,46,42,10,0,101
7955555286.jpg,0,0,38,62,2,102
7955776040.jpg,0,26,53,20,1,100
7956634196.jpg,0,24,76,9,0,109
7957309250.jpg,0,3,55,41,1,100
7957627098.jpg,4,52,47,2,0,105
7959317086.jpg,0,11,58,33,0,102
7963365940.jpg,1,36,62,5,0,104
7964487966.jpg,0,0,14,79,8,101
7964545096.jpg,32,73,5,0,0,110
7965307114.jpg,0,0,33,69,5,107
7967382050.jpg,12,55,36,2,0,105
7969243650.jpg,0,5,86,41,0,132
7969415278.jpg,0,12,77,12,1,102
7969516070.jpg,0,0,41,68,2,111
7969586312.jpg,1,8,41,52,3,105
7971560974.jpg,0,3,35,61,0,99
7972772456.jpg,0,3,48,53,0,104
7973547250.jpg,0,2,47,58,5,112
7974391613.jpg,0,0,24,71,2,97
7974813040.jpg,0,1,53,88,0,142
7974813912.jpg,1,16,64,19,1,101
7975750167.jpg,0,0,50,55,2,107
7977665407.jpg,10,86,12,0,0,108
7978014444.jpg,0,7,62,37,0,106
7978282630.jpg,0,24,77,7,0,108
7979358830.jpg,0,1,46,67,1,115
7979712862.jpg,1,9,70,23,0,103
7979893598.jpg,1,18,78,8,1,106
7980164509.jpg,0,15,76,13,0,104
7980394491.jpg,0,14,78,27,2,121
7981422171.jpg,4,24,58,19,0,105
7981733981.jpg,3,69,33,3,0,108
7983035556.jpg,0,1,40,61,1,103
7983388187.jpg,0,0,21,86,4,111
7983529291.jpg,5,36,57,5,0,103
7983700558.jpg,0,2,45,56,1,104
7984667593.jpg,0,18,78,13,0,109
7985643395.jpg,0,2,47,51,1,101
7987564601.jpg,0,10,67,26,0,103
7987926613.jpg,0,5,52,48,2,107
7989292953.jpg,2,33,51,16,1,103
7989520325.jpg,0,23,82,7,0,112
7991164057.jpg,0,5,61,35,1,102
7991223182.jpg,0,4,58,41,0,103
7991449337.jpg,0,0,21,65,13,99
7992243526.jpg,18,71,22,0,0,111
7992863678.jpg,0,3,57,42,0,102
7993315454.jpg,0,12,68,27,0,107
7993457702.jpg,1,17,68,18,0,104
7994018610.jpg,0,2,33,69,8,112
7994058325.jpg,1,20,61,16,0,98
7994313310.jpg,1,1,61,69,0,132
7996052982.jpg,0,3,52,44,0,99
7996349699.jpg,0,12,73,23,0,108
7998024612.jpg,0,6,57,34,1,98
7998388938.jpg,0,0,15,84,7,106
7998553110.jpg,0,2,24,78,7,111
7999186610.jpg,0,17,84,8,0,109
7999779242.jpg,0,0,48,58,1,107
7999886083.jpg,0,1,41,63,1,106
8000756995.jpg,4,40,52,6,0,102
8000770201.jpg,1,9,69,28,0,107
8001662105.jpg,0,8,69,29,0,106
8002007313.jpg,0,0,26,72,3,101
8003027258.jpg,0,20,69,13,0,102
8003457683.jpg,0,14,98,18,0,130
8003576007.jpg,0,3,66,40,0,109
8003923043.jpg,1,14,77,9,0,101
8005430981.jpg,0,1,26,67,7,101
8005792260.jpg,0,2,39,58,0,99
8006234274.jpg,0,0,26,79,5,110
8008251007.jpg,11,82,46,2,0,141
8008341376.jpg,0,4,51,49,1,105
8009325601.jpg,1,0,19,90,1,111
8009623425.jpg,0,2,34,68,2,106
8010069396.jpg,0,1,30,63,9,103
8010819148.jpg,0,0,53,51,0,104
8012731043.jpg,1,4,67,32,2,106
8015526971.jpg,0,0,32,56,19,107
8015637389.jpg,0,0,47,54,0,101
8015825692.jpg,0,2,58,50,1,111
8016728166.jpg,1,2,35,68,3,109
8016790601.jpg,0,7,61,53,4,125
8016871394.jpg,0,1,36,66,4,107
8016925192.jpg,0,2,51,49,1,103
8017805417.jpg,0,2,30,61,3,96
80184044.jpg,94,10,0,0,0,104
8019221019.jpg,0,54,83,3,0,140
8020716606.jpg,0,2,33,74,1,110
8020739978.jpg,0,1,44,57,3,105
8020768393.jpg,0,0,30,70,3,103
8021300262.jpg,0,0,44,69,7,120
8021353022.jpg,0,0,31,70,4,105
8021456503.jpg,0,0,35,72,2,109
8021464988.jpg,0,0,35,61,3,99
8022493551.jpg,0,12,68,25,1,106
8023712580.jpg,0,1,36,67,4,108
8023758470.jpg,0,0,54,51,2,107
8025466958.jpg,1,3,86,50,1,141
8026326591.jpg,0,1,33,62,4,100
8027425918.jpg,0,0,26,72,3,101
8030242803.jpg,1,13,66,26,0,106
8033033726.jpg,0,0,17,84,5,106
8033437927.jpg,1,5,60,32,2,100
8034708472.jpg,0,9,88,42,0,139
8034781018.jpg,0,0,14,84,4,102
8035433785.jpg,0,0,30,68,3,101
8035478082.jpg,7,69,22,0,0,98
8036033409.jpg,0,3,63,38,3,107
8036386438.jpg,0,0,25,85,1,111
8036607222.jpg,0,0,42,58,4,104
8039052171.jpg,0,8,44,46,4,102
8039894154.jpg,2,41,55,3,0,101
8040007574.jpg,0,1,19,69,11,100
8040267298.jpg,0,0,30,64,6,100
8040993311.jpg,14,79,13,3,0,109
8041277931.jpg,1,2,30,58,15,106
80417582.jpg,2,51,48,2,0,103
8041921391.jpg,0,2,34,66,1,103
8041987489.jpg,6,45,40,12,0,103
8042065108.jpg,0,0,42,62,2,106
8042361563.jpg,0,1,32,67,2,102
8042697281.jpg,0,6,59,39,3,107
8042762603.jpg,0,0,27,75,5,107
8043120593.jpg,0,2,47,59,4,112
8043238323.jpg,0,2,26,76,3,107
8043482690.jpg,0,13,54,33,4,104
8044678667.jpg,0,0,27,76,8,111
8044704113.jpg,0,2,53,42,3,100
8044706176.jpg,1,60,46,2,0,109
8045159223.jpg,0,33,60,12,0,105
8045790915.jpg,0,17,69,22,0,108
8046864953.jpg,0,2,59,45,1,107
8048106336.jpg,0,0,44,61,1,106
8049709940.jpg,0,22,58,22,0,102
80498915.jpg,0,5,55,42,1,103
8050471028.jpg,0,1,19,79,7,106
8050482362.jpg,0,4,66,34,0,104
8050953362.jpg,0,2,47,75,2,126
8051569032.jpg,0,2,28,77,1,108
8053452721.jpg,0,16,84,11,0,111
8054439590.jpg,3,66,40,0,0,109
8055471009.jpg,0,3,71,34,0,108
8055570957.jpg,3,48,67,3,0,121
8056188485.jpg,0,30,63,17,0,110
8056693769.jpg,0,5,51,46,4,106
8058467090.jpg,9,48,38,8,0,103
8059797614.jpg,0,6,64,34,0,104
8060303212.jpg,2,45,46,14,0,107
8060465172.jpg,0,5,56,39,1,101
8060595540.jpg,0,2,61,40,1,104
8062771626.jpg,0,0,17,76,15,108
8064104833.jpg,0,5,55,44,0,104
8064361291.jpg,2,56,44,1,0,103
8065579848.jpg,1,3,60,42,2,108
8066151099.jpg,0,11,81,19,1,112
8066534702.jpg,0,6,59,33,1,99
8066713457.jpg,0,4,61,40,2,107
8067632249.jpg,1,31,56,12,0,100
8069073334.jpg,0,8,79,19,0,106
8070731836.jpg,0,0,47,61,3,111
8072726562.jpg,0,18,81,9,0,108
8072879274.jpg,0,3,45,53,1,102
8073301888.jpg,0,3,59,44,0,106
8073500928.jpg,2,20,74,15,0,111
8073658473.jpg,0,0,19,75,6,100
8074116162.jpg,8,73,27,1,0,109
8074309631.jpg,0,3,52,46,3,104
8075121778.jpg,0,2,27,73,1,103
8076181424.jpg,0,1,16,76,8,101
8077318332.jpg,2,13,79,12,0,106
8077601732.jpg,1,4,57,38,2,102
8077634378.jpg,0,3,60,55,3,121
8078070846.jpg,38,64,8,0,0,110
8078731890.jpg,0,1,53,49,2,105
8079522861.jpg,0,9,62,28,2,101
8081563599.jpg,6,60,34,1,0,101
8081688318.jpg,0,3,48,50,0,101
8082249517.jpg,0,6,54,86,2,148
8083120146.jpg,0,0,16,85,5,106
8083395637.jpg,0,0,35,63,10,108
8083559682.jpg,0,0,12,86,12,110
8084074435.jpg,7,67,25,0,0,99
8084640023.jpg,27,59,14,2,0,102
8086705362.jpg,0,0,35,65,5,105
8086991348.jpg,0,2,32,68,4,106
8087032429.jpg,0,12,65,28,0,105
8087906672.jpg,0,0,37,66,3,106
8088105369.jpg,0,3,55,47,1,106
8088110789.jpg,0,0,19,70,11,100
8088364175.jpg,4,57,45,2,0,108
8089499290.jpg,0,2,51,53,3,109
8090282985.jpg,1,44,84,1,0,130
8090361774.jpg,10,53,36,2,0,101
8091151386.jpg,15,82,13,1,0,111
8093852043.jpg,1,27,63,14,0,105
8094310910.jpg,0,0,34,66,5,105
8094870766.jpg,0,1,45,62,2,110
80954980.jpg,0,8,51,44,3,106
8095635777.jpg,0,13,81,13,0,107
8095851163.jpg,0,16,74,14,0,104
8096129179.jpg,0,1,29,67,3,100
8100293037.jpg,0,5,41,57,4,107
8100313754.jpg,0,1,6,76,23,106
81006585.jpg,24,68,11,0,0,103
8100783568.jpg,0,5,71,31,0,107
8101870815.jpg,0,5,54,39,0,98
8102502953.jpg,0,3,62,36,1,102
8102673511.jpg,5,72,23,0,0,100
8103481984.jpg,0,32,63,12,0,107
8103867208.jpg,0,1,56,49,0,106
8104089685.jpg,0,10,64,29,1,104
8105160200.jpg,0,8,62,33,1,104
8106242836.jpg,0,11,61,32,0,104
8106557639.jpg,0,0,64,42,1,107
8106933398.jpg,0,7,30,66,2,105
8107402006.jpg,0,0,54,54,2,110
8107454103.jpg,0,2,22,74,12,110
8108582186.jpg,0,5,55,43,2,105
8108590859.jpg,6,76,17,2,0,101
8108709244.jpg,0,1,32,65,4,102
8108820426.jpg,0,1,15,78,10,104
8108912190.jpg,0,2,51,54,4,111
8109380358.jpg,0,39,85,2,0,126
8109558815.jpg,0,13,61,30,0,104
8109560495.jpg,0,0,24,79,2,105
8110370052.jpg,0,3,56,42,2,103
8113113251.jpg,0,3,60,45,1,109
8113190555.jpg,0,0,31,73,4,108
8113244210.jpg,0,0,23,84,3,110
8113245382.jpg,0,1,8,90,11,110
8113369457.jpg,0,2,38,63,2,105
8113498731.jpg,0,0,46,60,2,108
8114138182.jpg,0,0,27,73,7,107
8114369605.jpg,0,0,25,68,11,104
8115151138.jpg,0,5,58,45,0,108
8115433304.jpg,2,27,53,20,0,102
8116678978.jpg,0,0,21,78,4,103
8116711629.jpg,1,0,19,76,6,102
8118290739.jpg,1,6,75,26,0,108
8120535413.jpg,2,36,61,8,0,107
8120735257.jpg,0,3,36,69,0,108
8120809574.jpg,0,17,68,23,0,108
8121424411.jpg,1,39,52,9,0,101
8121591181.jpg,0,15,63,23,0,101
8121860471.jpg,0,2,56,45,3,106
8121986127.jpg,1,0,30,71,8,110
8122853098.jpg,5,55,68,5,0,133
8123324192.jpg,0,4,65,34,0,103
8125828960.jpg,0,16,68,17,0,101
8125869229.jpg,0,3,78,49,0,130
8126953338.jpg,0,5,92,43,0,140
8127311442.jpg,0,35,66,6,0,107
8127846229.jpg,1,37,52,13,0,103
8128148667.jpg,0,2,33,58,6,99
8128298263.jpg,0,2,16,92,4,114
8128596449.jpg,2,26,67,12,0,107
8128896956.jpg,4,34,52,12,1,103
8129021372.jpg,0,22,63,11,0,96
8129206186.jpg,0,4,49,75,4,132
81292981.jpg,42,56,7,0,0,105
8130387818.jpg,0,10,73,19,0,102
8130446271.jpg,0,2,80,31,0,113
8130469512.jpg,0,14,69,20,1,104
8130745750.jpg,0,14,68,20,0,102
8131856300.jpg,0,1,50,50,2,103
8132171428.jpg,0,3,56,44,1,104
8132808180.jpg,0,13,57,25,1,96
8132835141.jpg,0,0,3,79,20,102
8134031054.jpg,0,37,66,4,0,107
8135725807.jpg,0,1,44,55,5,105
8136167992.jpg,0,7,64,36,0,107
8137649050.jpg,0,5,44,60,1,110
8137709650.jpg,0,5,72,76,1,154
8137767984.jpg,48,50,4,0,0,102
8138101923.jpg,0,8,60,35,0,103
8141906514.jpg,0,12,64,29,0,105
8142530403.jpg,0,3,63,43,2,111
8142555462.jpg,0,37,57,8,0,102
8142580716.jpg,1,27,67,20,0,115
8142588958.jpg,0,1,45,59,0,105
8142609774.jpg,0,4,47,57,1,109
8142864218.jpg,0,3,75,53,0,131
8144270233.jpg,0,2,46,57,0,105
8144691822.jpg,0,3,30,63,8,104
8145791705.jpg,1,16,59,34,1,111
8148747862.jpg,0,1,33,72,0,106
8150322605.jpg,0,2,50,54,0,106
8152475637.jpg,2,49,49,3,0,103
8152535252.jpg,35,62,7,0,0,104
8152567908.jpg,0,13,72,28,0,113
8152645114.jpg,0,6,65,34,0,105
8154204617.jpg,0,2,38,67,5,112
8154345084.jpg,0,0,36,69,1,106
8154496951.jpg,0,22,61,15,0,98
8155106995.jpg,1,11,64,29,2,107
8156018718.jpg,0,2,18,83,5,108
8156608688.jpg,0,0,11,80,17,108
8157038620.jpg,0,3,32,65,5,105
8157117322.jpg,0,0,23,75,4,102
8157884969.jpg,2,58,61,13,1,135
8157886874.jpg,0,3,49,56,3,111
8158011851.jpg,0,1,42,62,0,105
8158072489.jpg,0,2,31,61,12,106
8158344434.jpg,0,1,40,63,1,105
8158453521.jpg,0,2,54,47,1,104
8159044184.jpg,0,12,47,44,3,106
8159815111.jpg,3,63,63,1,0,130
8161767113.jpg,1,5,55,47,2,110
8162335542.jpg,2,49,51,3,0,105
8162764501.jpg,0,0,27,69,10,106
8163644568.jpg,35,69,4,0,0,108
8164370728.jpg,1,13,68,22,0,104
8164688693.jpg,0,3,48,55,3,109
8165044722.jpg,2,32,55,18,0,107
8165323576.jpg,28,64,12,0,0,104
8166756819.jpg,1,29,57,21,0,108
8167486220.jpg,0,0,40,58,7,105
8167676296.jpg,5,39,55,5,0,104
8167934912.jpg,0,1,23,82,6,112
8169167251.jpg,0,9,70,23,0,102
8171751224.jpg,0,1,74,61,2,138
8171907364.jpg,7,79,19,0,0,105
8172599370.jpg,0,6,69,31,0,106
8174015928.jpg,2,44,48,8,0,102
8175674967.jpg,0,4,43,56,6,109
8175828572.jpg,0,1,38,68,2,109
8176025549.jpg,0,1,19,79,3,102
8176328950.jpg,0,1,55,47,1,104
8176381032.jpg,0,13,74,16,0,103
8177148898.jpg,0,4,71,24,2,101
8177168382.jpg,1,38,59,4,0,102
8178464033.jpg,0,0,27,73,4,104
8178540063.jpg,1,34,60,7,0,102
8178731250.jpg,0,2,45,62,1,110
8178834291.jpg,0,21,75,6,0,102
8179375247.jpg,0,0,17,84,2,103
8179397976.jpg,0,0,42,58,2,102
8179500414.jpg,0,0,25,70,3,98
8179614383.jpg,0,8,81,21,0,110
8179882827.jpg,0,0,44,55,3,102
8181726766.jpg,2,53,46,2,0,103
8182062575.jpg,0,46,53,6,0,105
8182393998.jpg,5,43,51,6,0,105
8183741020.jpg,0,2,48,55,0,105
8183781293.jpg,5,48,49,3,0,105
8183790186.jpg,0,5,58,44,0,107
8184075727.jpg,0,0,40,63,0,103
8184338593.jpg,1,40,65,1,0,107
8184978499.jpg,0,1,41,64,1,107
8185021640.jpg,0,0,27,81,4,112
8185807831.jpg,1,5,70,30,2,108
8185829074.jpg,0,1,47,53,6,107
8186224852.jpg,0,4,54,44,4,106
8186599780.jpg,0,31,85,18,1,135
818793256.jpg,1,11,66,29,1,108
8188022955.jpg,0,4,65,38,0,107
8188461365.jpg,0,7,67,34,0,108
8188524067.jpg,1,30,68,2,0,101
8189076643.jpg,0,2,17,75,7,101
8189726942.jpg,0,5,67,35,0,107
8191059336.jpg,0,1,47,74,1,123
8192678214.jpg,0,0,34,74,0,108
8192992760.jpg,0,7,71,27,0,105
8194129270.jpg,0,2,42,56,0,100
8194417466.jpg,0,0,17,82,9,108
8195268203.jpg,13,74,16,1,0,104
8195491375.jpg,1,28,59,15,1,104
8195543723.jpg,0,2,36,62,8,108
8195809276.jpg,0,19,79,11,0,109
8195917264.jpg,0,0,35,70,1,106
8196266010.jpg,6,50,41,3,0,100
8197822329.jpg,2,62,37,2,0,103
8199545794.jpg,0,0,23,71,10,104
8199731208.jpg,0,3,43,52,1,99
8199832249.jpg,1,6,62,36,0,105
8200520446.jpg,0,18,83,6,0,107
8201445603.jpg,0,2,38,61,3,104
8201535489.jpg,0,1,32,58,7,98
8201796429.jpg,0,1,28,76,1,106
8203037764.jpg,0,3,47,48,5,103
8203914551.jpg,0,4,26,71,6,107
8206370859.jpg,0,1,21,71,6,99
8207139364.jpg,0,31,62,9,0,102
8207322738.jpg,0,7,63,28,1,99
8207527983.jpg,0,3,68,28,0,99
8208615482.jpg,0,0,36,61,3,100
8208757707.jpg,0,42,63,6,0,111
8209638994.jpg,0,3,57,61,0,121
8209647019.jpg,0,0,27,71,7,105
8210031777.jpg,0,2,54,49,0,105
8210857374.jpg,0,1,54,50,0,105
8210890973.jpg,0,1,28,78,4,111
8211686846.jpg,1,16,77,11,0,105
8212033390.jpg,0,0,40,62,0,102
8212081020.jpg,0,28,73,3,0,104
8212301132.jpg,0,13,75,12,1,101
8213284057.jpg,1,23,54,29,0,107
8213296844.jpg,0,31,73,5,0,109
8214901795.jpg,0,3,54,47,0,104
8215066958.jpg,0,3,65,35,0,103
8215413789.jpg,0,3,66,38,0,107
8216118608.jpg,0,0,52,54,0,106
8216243918.jpg,1,14,100,21,0,136
8216954885.jpg,0,0,27,81,3,111
8217034676.jpg,53,45,5,0,0,103
8218123958.jpg,10,84,14,0,0,108
82183009.jpg,6,60,36,3,0,105
8218739759.jpg,0,4,67,72,2,145
8218987987.jpg,0,1,12,72,19,104
8219032452.jpg,6,50,46,4,0,106
8219528225.jpg,0,14,74,12,0,100
8220742117.jpg,32,60,8,1,0,101
8221139072.jpg,0,0,42,65,2,109
8222142608.jpg,9,80,15,1,0,105
8222741744.jpg,1,18,70,22,0,111
8223457724.jpg,4,67,36,2,0,109
8225184235.jpg,3,48,50,3,0,104
8225506418.jpg,0,1,29,68,7,105
8226831484.jpg,1,14,70,28,0,113
8228733135.jpg,0,10,65,29,0,104
8228800442.jpg,0,1,42,60,3,106
8228841274.jpg,0,5,68,36,0,109
8229120528.jpg,0,29,94,5,0,128
8229585759.jpg,0,22,50,34,2,108
8229993789.jpg,0,5,63,38,0,106
8230351643.jpg,12,71,21,1,0,105
8230377264.jpg,3,68,58,1,0,130
8230394579.jpg,0,4,57,45,3,109
8230396549.jpg,1,20,65,14,1,101
8230450365.jpg,0,9,65,23,0,97
8230728519.jpg,0,1,49,54,1,105
8231125615.jpg,0,8,56,40,2,106
8231492407.jpg,0,1,61,44,0,106
8232299487.jpg,1,20,68,11,0,100
8232391054.jpg,0,5,74,25,1,105
8232440995.jpg,1,3,41,52,3,100
8232481457.jpg,2,35,66,3,0,106
8233745351.jpg,0,3,53,76,0,132
8234020680.jpg,4,78,54,1,0,137
8236704145.jpg,0,4,57,75,3,139
8236758432.jpg,0,4,38,68,3,113
823805862.jpg,5,75,27,0,0,107
8238462203.jpg,0,0,21,67,20,108
8239827069.jpg,0,15,66,26,0,107
8240021404.jpg,2,11,64,32,1,110
8240214052.jpg,7,54,32,7,0,100
8240220210.jpg,1,41,66,5,0,113
8241257694.jpg,0,2,48,52,0,102
82421401.jpg,31,65,7,1,0,104
8242266673.jpg,0,1,35,60,3,99
8242599767.jpg,0,1,43,56,1,101
8242811234.jpg,0,3,56,41,0,100
8242906564.jpg,33,58,13,1,0,105
8244017611.jpg,0,8,61,35,0,104
8244040268.jpg,0,0,36,58,4,98
8245350767.jpg,0,0,29,69,2,100
8246007228.jpg,0,13,79,8,0,100
8246184591.jpg,1,31,92,12,0,136
8246479044.jpg,0,1,68,37,1,107
8246841627.jpg,0,0,13,71,16,100
8247215463.jpg,0,2,37,59,3,101
8247844062.jpg,1,4,55,40,3,103
8248519358.jpg,0,1,27,73,3,104
8248564902.jpg,0,1,39,65,2,107
8249630967.jpg,0,6,76,25,0,107
8250498441.jpg,1,4,86,31,0,122
8251327289.jpg,0,31,64,14,1,110
8252742940.jpg,0,2,14,64,28,108
8253280616.jpg,0,7,66,26,0,99
8253601805.jpg,0,2,56,44,2,104
8256049516.jpg,0,5,57,40,0,102
8256076417.jpg,0,4,90,18,0,112
8256731117.jpg,0,26,71,10,0,107
8256977391.jpg,0,1,51,53,3,108
8257636356.jpg,0,0,41,56,1,98
8257779790.jpg,23,76,7,1,0,107
8258234240.jpg,0,1,39,69,3,112
8259404043.jpg,0,1,27,73,0,101
8259557757.jpg,0,4,57,33,0,94
8260840073.jpg,2,20,76,9,0,107
8261560586.jpg,0,3,46,52,0,101
8262387641.jpg,0,2,50,55,1,108
8262794558.jpg,0,34,59,10,0,103
8262966434.jpg,0,3,74,29,1,107
8263016549.jpg,0,15,77,9,2,103
8263420706.jpg,2,28,66,10,0,106
826373.jpg,0,8,23,48,28,107
8266041849.jpg,0,2,42,55,4,103
8266134524.jpg,1,33,63,7,0,104
8266648992.jpg,0,0,35,65,4,104
8267105534.jpg,0,0,24,74,12,110
8267153015.jpg,0,0,36,68,1,105
8267201129.jpg,0,1,42,60,9,112
8267353806.jpg,0,2,52,49,3,106
8267786798.jpg,0,28,71,10,0,109
8268523027.jpg,3,38,56,9,0,106
8268756631.jpg,0,0,36,72,0,108
8268859988.jpg,2,44,56,2,0,104
8269777387.jpg,0,15,67,12,1,95
8269784088.jpg,4,32,63,14,0,113
8270648540.jpg,0,4,63,34,1,102
8270671503.jpg,2,14,69,24,0,109
827067298.jpg,0,0,48,58,1,107
8270913623.jpg,1,4,58,41,0,104
8272075374.jpg,1,9,55,40,0,105
8272706512.jpg,0,7,67,35,1,110
8273944978.jpg,0,18,73,8,0,99
8273957786.jpg,0,40,58,7,0,105
8274584258.jpg,0,1,19,75,10,105
8274829582.jpg,0,0,6,99,8,113
8275793121.jpg,0,22,44,34,3,103
8278414113.jpg,0,15,105,25,0,145
8279922752.jpg,0,0,32,64,6,102
8281818195.jpg,7,63,49,2,0,121
8282376526.jpg,0,5,74,26,0,105
82824130.jpg,20,58,24,3,0,105
8282451903.jpg,0,0,29,68,3,100
8282948203.jpg,1,18,96,9,0,124
8283257984.jpg,5,52,45,3,0,105
8283451606.jpg,0,4,49,56,1,110
8283511236.jpg,0,0,19,78,12,109
8284022272.jpg,0,1,46,64,1,112
8285094496.jpg,0,7,64,35,1,107
8286418266.jpg,0,0,34,72,1,107
8287040167.jpg,5,34,54,10,1,104
8287545136.jpg,1,40,56,7,0,104
8288312901.jpg,0,2,38,61,3,104
8288373596.jpg,0,0,15,80,7,102
8289927707.jpg,0,3,58,47,0,108
8291626660.jpg,0,4,52,56,1,113
8292084929.jpg,0,0,39,64,3,106
8292596709.jpg,4,23,59,19,0,105
8292826193.jpg,0,4,82,17,0,103
8293206684.jpg,0,5,46,45,4,100
8293797976.jpg,0,8,72,19,0,99
8296218747.jpg,1,14,88,25,0,128
8297827964.jpg,0,6,64,32,1,103
8297923368.jpg,1,2,55,69,0,127
8299135149.jpg,0,8,47,46,7,108
8299281180.jpg,0,1,30,72,4,107
8300309247.jpg,2,59,41,9,0,111
8301114122.jpg,0,26,102,12,0,140
8301271447.jpg,0,2,63,40,1,106
8302396098.jpg,0,3,40,60,1,104
8302682948.jpg,0,2,43,63,4,112
8303486295.jpg,0,2,14,78,13,107
8303662528.jpg,0,5,56,43,1,105
8303933730.jpg,1,17,51,40,1,110
8303968382.jpg,0,1,69,32,0,102
8304043296.jpg,0,2,27,73,10,112
8304558173.jpg,0,0,12,84,15,111
8304722901.jpg,0,3,61,37,1,102
8305212885.jpg,2,36,67,3,0,108
8305612260.jpg,0,6,75,24,0,105
8305620668.jpg,10,70,22,2,0,104
8305669061.jpg,0,1,34,64,3,102
8306155022.jpg,0,0,13,84,13,110
8306749332.jpg,0,2,33,69,3,107
8306770184.jpg,0,2,53,43,1,99
8307817608.jpg,19,50,34,3,0,106
8308200442.jpg,0,2,50,53,0,105
8308350290.jpg,0,0,61,43,0,104
8308811931.jpg,0,37,67,2,0,106
8309215514.jpg,26,60,15,0,0,101
8310254529.jpg,0,2,30,75,2,109
8310618188.jpg,0,8,72,28,0,108
8310619532.jpg,0,10,65,25,2,102
8311563943.jpg,0,2,42,63,2,109
8314358374.jpg,0,19,76,7,0,102
8314966745.jpg,8,73,19,1,0,101
8316898244.jpg,0,3,41,65,1,110
8317893385.jpg,0,0,27,76,5,108
8318268016.jpg,0,1,58,47,2,108
8319445883.jpg,0,4,36,65,5,110
8320017511.jpg,0,0,23,73,10,106
8320098796.jpg,0,16,76,17,0,109
8320423007.jpg,6,49,39,1,0,95
8320489600.jpg,0,11,80,40,1,132
8320909145.jpg,0,9,58,34,1,102
8321029602.jpg,0,5,71,28,0,104
8321126258.jpg,0,20,69,23,1,113
8321155777.jpg,0,12,81,13,0,106
8321480608.jpg,1,25,76,13,0,115
8321682395.jpg,0,7,56,36,0,99
8321981131.jpg,1,12,58,31,2,104
8322388606.jpg,0,16,73,23,0,112
8322413607.jpg,0,2,31,75,4,112
8322643928.jpg,12,68,22,1,0,103
8322994549.jpg,0,10,75,16,0,101
8323120996.jpg,0,2,53,49,1,105
8325420861.jpg,0,3,55,50,0,108
8325732255.jpg,0,1,43,56,6,106
8329144701.jpg,0,20,51,28,2,101
8329938246.jpg,0,0,54,48,2,104
8329958275.jpg,0,0,22,75,9,106
8329986781.jpg,0,2,64,35,3,104
8330723470.jpg,0,0,43,61,4,108
8330807035.jpg,6,61,38,2,0,107
8331586612.jpg,0,7,54,48,0,109
8331607175.jpg,0,1,37,71,1,110
8331758509.jpg,0,6,77,65,3,151
8332215391.jpg,0,0,31,70,2,103
8333161105.jpg,0,0,42,60,3,105
8333619480.jpg,2,24,58,20,0,104
8333683532.jpg,0,0,42,65,0,107
8333814090.jpg,2,32,56,14,0,104
8333982072.jpg,1,23,75,9,0,108
8334203333.jpg,0,34,70,8,0,112
8334314471.jpg,1,11,73,16,0,101
8336846212.jpg,0,1,58,48,0,107
8337813363.jpg,0,2,40,68,1,111
8338842182.jpg,0,3,58,48,0,109
8339157161.jpg,0,5,52,43,4,104
8339210713.jpg,0,11,42,56,1,110
8339615907.jpg,3,44,51,6,0,104
8341991106.jpg,0,0,25,74,6,105
8342894979.jpg,0,27,75,4,0,106
8343118972.jpg,0,1,25,67,12,105
8343579007.jpg,0,6,64,37,0,107
8345197886.jpg,0,4,64,36,1,105
8345496530.jpg,0,2,31,64,9,106
8346047313.jpg,0,0,53,58,0,111
8346245093.jpg,0,31,64,8,0,103
8346970641.jpg,0,19,68,11,0,98
8347284037.jpg,0,8,75,29,1,113
8348001072.jpg,0,13,57,33,0,103
8348113359.jpg,21,71,11,0,0,103
8349327834.jpg,3,37,87,6,0,133
8350531104.jpg,0,4,48,52,1,105
8350532456.jpg,0,3,44,60,3,110
8350811947.jpg,1,2,24,64,20,111
8351013561.jpg,0,19,79,12,0,110
8351568109.jpg,0,3,75,25,1,104
8351745980.jpg,0,4,73,20,0,97
8351819316.jpg,0,1,50,47,6,104
8351907965.jpg,0,1,30,64,4,99
8352296647.jpg,59,47,1,0,0,107
8352587213.jpg,0,8,64,34,1,107
8352959449.jpg,0,3,84,20,0,107
8353048335.jpg,0,4,68,33,2,107
8353276755.jpg,0,2,43,61,1,107
8353492181.jpg,9,78,22,0,0,109
8353646596.jpg,0,1,56,46,1,104
8354332729.jpg,0,19,77,10,0,106
8354479425.jpg,4,26,61,10,0,101
8354529751.jpg,0,0,40,62,1,103
8354584594.jpg,0,5,62,38,3,108
8354855845.jpg,0,3,41,57,1,102
8356375190.jpg,0,1,30,90,3,124
8356442304.jpg,0,3,54,44,1,102
8357037213.jpg,0,0,44,55,3,102
8357323256.jpg,0,0,74,35,1,110
8357910475.jpg,0,1,29,71,6,107
8357913829.jpg,2,51,53,3,0,109
8358094625.jpg,0,0,19,83,2,104
8358374077.jpg,0,2,50,49,1,102
8358381896.jpg,0,5,75,21,0,101
8358982372.jpg,0,2,52,54,0,108
8360589310.jpg,0,1,61,44,0,106
8360975985.jpg,3,57,47,2,0,109
8362126677.jpg,0,3,61,42,1,107
8362183655.jpg,0,4,42,56,0,102
8362338513.jpg,0,29,78,5,0,112
8362730833.jpg,0,5,90,59,0,154
8364603294.jpg,1,0,19,73,14,107
8365545870.jpg,0,3,43,77,1,124
8373140830.jpg,0,5,68,36,0,109
8373449722.jpg,0,4,72,31,0,107
8373530988.jpg,28,61,16,0,0,105
8374149596.jpg,17,71,13,0,0,101
8374735482.jpg,0,3,54,46,0,103
8375094776.jpg,0,1,40,60,3,104
8375633718.jpg,2,41,75,10,0,128
8375881781.jpg,0,22,60,27,0,109
8376951271.jpg,0,2,33,68,8,111
8377051997.jpg,2,32,65,5,0,104
8377086521.jpg,0,4,44,50,6,104
8377336301.jpg,0,1,44,55,4,104
8377341554.jpg,0,2,29,64,8,103
8377908446.jpg,0,1,31,68,6,106
8379165496.jpg,0,17,75,13,0,105
8379707865.jpg,0,2,37,67,2,108
8380369304.jpg,6,49,44,1,0,100
8380814455.jpg,0,23,64,19,0,106
8381849363.jpg,0,1,42,62,4,109
8382215237.jpg,0,0,14,85,9,108
8385356062.jpg,0,5,55,40,2,102
8385411442.jpg,0,4,55,58,1,118
8385499383.jpg,0,2,50,53,0,105
8385552455.jpg,0,2,14,78,7,101
8386378049.jpg,0,3,55,45,0,103
8387369354.jpg,0,1,23,76,7,107
8387487827.jpg,0,6,57,51,0,114
8388736592.jpg,0,22,79,7,0,108
8390342452.jpg,0,14,68,17,0,99
8390448317.jpg,0,2,49,50,1,102
8391472456.jpg,0,1,56,49,3,109
8391500206.jpg,0,37,61,6,0,104
8391854291.jpg,0,24,76,5,0,105
8392357033.jpg,0,5,45,53,3,106
8392513010.jpg,39,58,10,1,0,108
8393106944.jpg,29,62,9,1,0,101
8393175128.jpg,0,2,44,58,1,105
83935018.jpg,1,39,57,9,0,106
8395711832.jpg,5,50,54,2,0,111
8395743743.jpg,0,4,38,53,13,108
8396870268.jpg,0,31,67,12,1,111
8397014400.jpg,0,14,75,15,0,104
8397266843.jpg,0,2,40,56,1,99
8397860756.jpg,0,12,79,18,0,109
8397958686.jpg,0,3,69,29,0,101
8398198583.jpg,0,0,22,71,13,106
8398239689.jpg,2,9,74,22,0,107
8398319915.jpg,0,1,48,59,2,110
8398445064.jpg,0,10,51,41,1,103
8398548523.jpg,0,9,72,27,0,108
8399489944.jpg,0,5,76,31,0,112
8399629946.jpg,0,3,60,45,1,109
8399674675.jpg,0,1,58,45,0,104
8400156034.jpg,0,8,75,25,0,108
8400557154.jpg,0,5,67,33,0,105
8400786727.jpg,0,1,21,80,0,102
8401142586.jpg,0,3,63,37,2,105
8401260771.jpg,0,11,67,23,1,102
8401416435.jpg,0,0,28,63,11,102
84018414.jpg,0,9,50,40,3,102
8402267016.jpg,4,21,60,20,0,105
8402295544.jpg,0,8,65,27,1,101
8403125101.jpg,0,3,50,52,0,105
8403312891.jpg,2,34,64,4,0,104
8403342715.jpg,0,28,67,7,0,102
8404206319.jpg,0,4,59,46,1,110
8404905802.jpg,1,31,68,10,0,110
8405074808.jpg,0,5,56,47,1,109
8405979865.jpg,1,23,95,9,0,128
8406395791.jpg,0,2,50,54,2,108
8406491085.jpg,0,0,38,68,0,106
8407650196.jpg,0,21,85,33,6,145
8407751062.jpg,1,9,77,16,0,103
8410633059.jpg,0,1,64,37,1,103
8410894233.jpg,2,34,59,10,0,105
8412239545.jpg,0,0,8,81,19,108
8412287695.jpg,0,1,49,51,1,102
8412460969.jpg,6,56,45,2,0,109
8413383096.jpg,4,29,61,4,0,98
8413515646.jpg,0,0,10,73,17,100
8416061748.jpg,0,4,38,62,3,107
8417110649.jpg,0,34,60,10,0,104
8417199212.jpg,0,4,52,48,1,105
8417650354.jpg,0,4,45,58,0,107
8417733554.jpg,0,4,46,51,3,104
8418843841.jpg,0,6,66,27,0,99
8418966442.jpg,0,40,58,7,1,106
8419228451.jpg,0,0,32,71,1,104
8419805674.jpg,0,1,16,79,11,107
8420816712.jpg,2,48,58,6,0,114
8421578109.jpg,0,7,71,34,0,112
8421980802.jpg,0,6,43,57,4,110
8423036726.jpg,0,0,37,67,2,106
8423951722.jpg,0,7,64,30,2,103
8425720386.jpg,0,15,65,14,0,94
8427357000.jpg,1,0,37,63,9,110
8427536839.jpg,0,3,54,37,2,96
8427827661.jpg,1,12,71,22,0,106
8428610140.jpg,0,2,51,51,0,104
8428991513.jpg,9,70,26,1,0,106
8429194888.jpg,1,9,71,28,0,109
8429377035.jpg,0,20,62,22,0,104
8430005179.jpg,0,0,34,65,0,99
8430044905.jpg,2,15,69,19,0,105
8430084372.jpg,0,25,68,7,0,100
8430377800.jpg,1,19,64,18,0,102
8430770537.jpg,0,1,32,62,10,105
8431773301.jpg,0,6,53,47,4,110
8431868669.jpg,0,2,51,53,2,108
8432266484.jpg,15,59,30,4,0,108
8433107122.jpg,0,1,42,58,3,104
8433138741.jpg,0,1,33,71,2,107
8434015762.jpg,0,31,65,10,1,107
8434381156.jpg,6,98,36,1,0,141
8434827647.jpg,0,0,20,85,3,108
8435700290.jpg,0,1,39,66,1,107
8435902776.jpg,0,5,41,50,3,99
8436817796.jpg,0,1,37,61,1,100
8436929518.jpg,0,23,78,5,0,106
8437453575.jpg,6,30,52,8,1,97
8437525605.jpg,0,20,45,40,0,105
8437609150.jpg,0,0,16,81,7,104
8438194819.jpg,0,0,26,66,7,99
8438205347.jpg,0,0,52,50,2,104
8438601990.jpg,0,5,57,43,1,106
8438721601.jpg,0,0,22,76,11,109
8438943296.jpg,1,20,55,28,1,105
8439178228.jpg,2,32,61,10,0,105
8439638054.jpg,0,7,46,53,1,107
8439881076.jpg,0,6,69,32,0,107
8441623412.jpg,0,2,37,76,1,116
8442013836.jpg,1,41,82,7,0,131
8442383096.jpg,2,42,45,11,1,101
8442848364.jpg,0,0,45,62,3,110
8442858810.jpg,2,20,61,21,0,104
8443583255.jpg,0,2,32,71,8,113
8443782912.jpg,0,6,54,45,1,106
8444194286.jpg,0,14,76,11,0,101
8444203927.jpg,0,5,60,43,0,108
8444344132.jpg,0,29,63,9,0,101
8444615248.jpg,0,0,46,52,1,99
8445666777.jpg,0,1,35,71,4,111
8446141044.jpg,0,2,63,44,1,110
8447352918.jpg,3,37,57,6,0,103
8448710097.jpg,0,9,65,25,1,100
8449030791.jpg,0,5,63,37,1,106
8449623916.jpg,0,3,32,67,2,104
8450680026.jpg,0,5,57,43,2,107
8450836581.jpg,0,0,47,54,6,107
8450870263.jpg,0,10,65,23,0,98
8451346661.jpg,0,0,18,89,3,110
8451439208.jpg,0,0,50,52,2,104
8451928629.jpg,0,0,20,86,4,110
8452429942.jpg,16,71,16,0,0,103
8452437121.jpg,0,4,41,54,1,100
8452461056.jpg,0,0,23,71,8,102
8452514438.jpg,4,48,53,1,0,106
8452772155.jpg,0,6,33,53,3,95
8454542185.jpg,0,3,49,53,2,107
8454689689.jpg,0,3,50,53,4,110
8454945247.jpg,1,28,67,9,1,106
8455329161.jpg,0,2,17,80,3,102
8456262039.jpg,0,27,65,13,0,105
8456415044.jpg,0,2,20,76,5,103
8456644085.jpg,0,7,72,23,0,102
8457028188.jpg,0,1,21,86,4,112
8458155212.jpg,0,0,49,56,1,106
8458232440.jpg,0,7,64,37,0,108
8458755761.jpg,0,1,49,55,0,105
8459688085.jpg,1,35,91,13,0,140
8459996431.jpg,0,2,51,48,1,102
8460154333.jpg,1,41,48,12,0,102
8460289501.jpg,0,4,62,34,1,101
8460376605.jpg,0,0,24,72,7,103
8460764072.jpg,1,51,49,0,0,101
8461148661.jpg,0,32,63,4,0,99
8461542458.jpg,2,49,42,5,1,99
8462442319.jpg,0,1,24,63,17,105
8463119506.jpg,0,0,30,67,10,107
8463181410.jpg,0,36,64,7,0,107
8463190672.jpg,0,2,57,48,0,107
8463285530.jpg,0,41,104,5,0,150
8464327703.jpg,0,3,65,69,0,137
8464428247.jpg,23,74,5,0,0,102
8465039467.jpg,1,26,65,9,0,101
8465276999.jpg,0,2,41,67,0,110
8465545790.jpg,0,8,69,32,0,109
8465866576.jpg,0,0,32,71,1,104
8466537488.jpg,0,1,33,66,1,101
8466719811.jpg,0,1,47,62,1,111
8467715346.jpg,0,3,73,61,0,137
8467804997.jpg,0,9,61,33,1,104
8468013032.jpg,1,13,66,23,0,103
8468299060.jpg,0,8,66,27,0,101
8468581524.jpg,1,10,57,42,0,110
8468743988.jpg,0,2,25,73,3,103
8469388516.jpg,0,11,69,19,4,103
8471068172.jpg,1,7,66,38,1,113
8471534118.jpg,0,14,63,29,0,106
8471619926.jpg,3,20,76,9,0,108
8472852630.jpg,1,4,36,60,4,105
8472898292.jpg,15,69,30,0,0,114
8473031499.jpg,0,11,58,32,0,101
8473167636.jpg,0,5,56,42,5,108
8473442365.jpg,0,1,31,75,4,111
8473611231.jpg,52,48,2,0,0,102
8473751363.jpg,0,2,43,54,3,102
8474310923.jpg,0,4,65,38,1,108
8474312023.jpg,0,2,48,57,2,109
8474594407.jpg,0,6,58,36,1,101
8475086246.jpg,0,0,54,52,0,106
8477555984.jpg,0,4,67,39,0,110
8481080192.jpg,0,5,56,42,2,105
8481265200.jpg,0,0,38,65,2,105
8481450412.jpg,5,52,38,4,0,99
8481724236.jpg,5,51,50,5,0,111
8482992711.jpg,0,18,70,22,0,110
8484679828.jpg,0,1,40,64,5,110
8484786490.jpg,0,7,86,57,2,152
8485122834.jpg,0,1,49,66,5,121
8485208349.jpg,0,17,74,39,2,132
8485295618.jpg,0,22,72,11,0,105
8485747318.jpg,0,2,40,59,1,102
8486309874.jpg,0,3,39,64,6,112
8486814802.jpg,0,2,30,68,3,103
8486846186.jpg,0,1,31,68,1,101
8486986414.jpg,0,9,82,36,2,129
8488083858.jpg,0,4,47,75,1,127
8488084256.jpg,0,4,58,58,1,121
8488319324.jpg,0,0,19,81,10,110
8488394767.jpg,0,1,54,49,1,105
8488457246.jpg,0,3,69,34,1,107
8488826556.jpg,0,0,42,61,2,105
8489199003.jpg,0,0,20,82,2,104
8489243270.jpg,0,6,76,16,0,98
8491632656.jpg,3,63,34,1,0,101
8492640738.jpg,0,17,61,17,0,95
8492768208.jpg,0,1,41,61,1,104
8493065081.jpg,0,1,30,63,8,102
8494026131.jpg,4,54,43,6,0,107
8494992418.jpg,0,1,57,43,4,105
8496798280.jpg,0,9,36,58,2,105
8496923161.jpg,0,7,57,39,4,107
8497413134.jpg,0,4,47,54,1,106
8497829320.jpg,0,5,58,37,0,100
8498158756.jpg,0,0,13,83,9,105
8498176247.jpg,0,9,97,21,0,127
8498192267.jpg,2,60,41,3,0,106
8498296013.jpg,1,39,57,2,0,99
8499771607.jpg,0,5,47,43,1,96
8501012764.jpg,0,27,59,18,0,104
8501628435.jpg,0,1,56,42,0,99
8501698385.jpg,0,2,50,56,2,110
8501713418.jpg,0,0,20,69,15,104
8502191647.jpg,0,0,53,51,0,104
8502941912.jpg,0,10,80,9,1,100
8503429334.jpg,0,2,32,68,2,104
8503728878.jpg,4,54,46,1,0,105
8503871115.jpg,0,2,71,33,0,106
8503982189.jpg,0,0,25,77,5,107
8504046996.jpg,2,41,55,9,0,107
8504332753.jpg,0,36,66,5,0,107
8504503946.jpg,0,1,53,47,0,101
8505294712.jpg,0,0,51,54,2,107
8506109338.jpg,0,13,70,24,0,107
8506145736.jpg,2,75,30,0,0,107
8506515372.jpg,0,2,48,61,1,112
8506941154.jpg,0,7,75,22,1,105
8507000235.jpg,40,58,6,1,0,105
8507554609.jpg,0,3,75,28,0,106
8509120510.jpg,0,4,91,33,0,128
8509241021.jpg,8,69,27,1,0,105
8510093470.jpg,0,3,38,62,5,108
8510431014.jpg,0,20,56,29,0,105
8511131771.jpg,2,37,55,11,1,106
8511620322.jpg,0,9,86,13,0,108
8511720535.jpg,0,9,56,37,1,103
85119046.jpg,6,60,37,2,0,105
8512098446.jpg,0,13,70,24,0,107
8512455050.jpg,0,9,69,25,0,103
8514709398.jpg,1,46,55,3,0,105
8515006370.jpg,0,21,68,22,1,112
8515263910.jpg,0,19,58,28,0,105
8515582085.jpg,0,3,56,48,2,109
8515635261.jpg,0,0,16,83,9,108
8516080909.jpg,1,0,55,47,3,106
8517283347.jpg,0,2,54,47,2,105
8517500456.jpg,0,0,40,70,1,111
8517575081.jpg,0,0,23,81,4,108
8517833832.jpg,7,62,30,3,0,102
8518560636.jpg,0,14,71,24,0,109
8518610606.jpg,0,16,68,22,0,106
8519367340.jpg,0,3,62,41,0,106
8520265759.jpg,0,21,69,13,0,103
8520990466.jpg,0,9,77,20,0,106
8521866643.jpg,0,1,16,76,11,104
8522041587.jpg,0,7,74,23,1,105
8522094125.jpg,0,3,60,38,1,102
8522481331.jpg,6,31,58,8,0,103
8522515607.jpg,0,27,66,11,0,104
8522546794.jpg,11,71,22,0,0,104
8523298395.jpg,0,3,58,41,0,102
8523540447.jpg,0,5,43,49,5,102
8523976721.jpg,0,6,55,44,4,109
85240920.jpg,0,46,43,12,0,101
8524995451.jpg,0,19,73,11,0,103
8525376754.jpg,0,34,97,5,0,136
8527988312.jpg,0,0,24,81,1,106
8528201518.jpg,0,0,29,68,10,107
8528934790.jpg,0,0,43,63,1,107
8529310556.jpg,0,3,45,54,1,103
8529310804.jpg,0,3,47,54,1,105
8529412192.jpg,0,25,60,15,0,100
8529490962.jpg,1,4,76,24,0,105
8529541053.jpg,0,9,79,18,0,106
8529705971.jpg,0,0,28,73,2,103
8530273249.jpg,0,10,68,23,0,101
8530355188.jpg,4,56,36,2,0,98
8530869068.jpg,0,1,61,43,0,105
8531375153.jpg,0,2,37,55,4,98
8531633123.jpg,0,0,20,73,14,107
8532549490.jpg,1,1,44,64,1,111
8532727626.jpg,0,0,48,57,4,109
8533373653.jpg,0,3,76,28,1,108
8533805271.jpg,0,12,65,25,2,104
8534896880.jpg,0,0,42,60,3,105
8535035859.jpg,2,22,77,4,0,105
8535232822.jpg,0,1,45,53,4,103
8537113381.jpg,0,38,65,4,0,107
8539118741.jpg,4,14,62,26,1,107
8539488665.jpg,0,1,59,40,1,101
8539498079.jpg,1,11,63,27,0,102
8539554428.jpg,0,1,43,63,1,108
8539670364.jpg,1,6,74,24,2,107
8540532034.jpg,0,22,66,14,0,102
8541006859.jpg,0,7,55,40,0,102
8544556866.jpg,0,1,63,45,0,109
8545406642.jpg,0,1,44,55,2,102
8545722241.jpg,1,22,67,16,2,108
8545905705.jpg,8,82,18,2,0,110
8546237134.jpg,0,24,70,11,0,105
8546536299.jpg,0,4,37,59,8,108
8546547724.jpg,0,0,16,82,11,109
8546838188.jpg,0,30,73,3,0,106
8546849368.jpg,1,7,50,41,1,100
8547424731.jpg,0,1,36,64,4,105
8549362115.jpg,0,11,60,36,0,107
8549600155.jpg,0,0,36,66,3,105
8550306054.jpg,2,20,70,8,0,100
8550575599.jpg,0,9,73,24,0,106
8550746603.jpg,0,1,12,78,15,106
8551222492.jpg,0,0,19,78,7,104
8551620615.jpg,0,1,41,60,3,105
8552101917.jpg,11,56,29,3,0,99
8552550792.jpg,1,31,62,5,0,99
8552590099.jpg,0,0,35,71,0,106
8552740610.jpg,4,74,24,0,0,102
8553006135.jpg,0,5,47,47,1,100
8553130419.jpg,0,10,63,31,1,105
8553449461.jpg,0,2,39,68,1,110
8553471741.jpg,0,18,64,20,1,103
8554033162.jpg,0,0,32,72,1,105
8554330315.jpg,0,2,32,63,5,102
8555190491.jpg,0,2,39,62,0,103
8556005393.jpg,5,53,43,3,0,104
8556290824.jpg,0,5,51,42,1,99
8556730555.jpg,0,12,60,23,1,96
8556786880.jpg,0,1,35,71,3,110
8558582535.jpg,0,9,69,27,1,106
8559592041.jpg,0,4,79,24,0,107
8560160557.jpg,0,15,65,28,0,108
8560249138.jpg,0,13,79,18,0,110
8560249157.jpg,6,70,31,3,0,110
8561557613.jpg,0,2,72,27,0,101
8562649420.jpg,0,5,66,37,2,110
8564299084.jpg,0,2,60,38,0,100
8564706371.jpg,0,0,41,63,2,106
8565023764.jpg,0,7,79,17,1,104
8565939221.jpg,1,52,48,4,0,105
8565941333.jpg,0,2,35,64,2,103
8565990156.jpg,0,3,38,61,1,103
8566161884.jpg,0,23,61,17,0,101
8567636458.jpg,1,18,61,32,0,112
8567878134.jpg,2,26,53,24,3,108
8568057395.jpg,0,7,78,24,0,109
8568663212.jpg,0,1,19,79,3,102
8568761304.jpg,3,32,64,8,0,107
8568890785.jpg,0,0,54,47,1,102
8569001906.jpg,0,1,28,70,9,108
8570186179.jpg,0,8,76,17,0,101
8570770544.jpg,0,5,72,27,0,104
8572309728.jpg,0,1,44,85,1,131
8572873286.jpg,0,11,70,28,0,109
8573160777.jpg,0,27,59,16,0,102
8573294301.jpg,6,68,30,0,0,104
8575096989.jpg,0,7,61,36,1,105
8580729000.jpg,0,2,29,68,1,100
8581043227.jpg,0,2,28,70,4,104
8582877561.jpg,0,0,57,39,3,99
8583578292.jpg,0,0,29,74,1,104
8583898549.jpg,0,3,60,40,0,103
8585320404.jpg,0,5,51,45,1,102
8586661877.jpg,0,1,18,66,21,106
8587794241.jpg,0,14,70,17,0,101
8588348191.jpg,0,18,68,19,0,105
8589152246.jpg,0,0,19,84,7,110
8589157666.jpg,7,77,23,1,0,108
8589543288.jpg,0,1,28,75,1,105
8590374545.jpg,0,2,57,42,2,103
8590498036.jpg,0,0,21,78,8,107
8590640853.jpg,0,2,60,65,0,127
8591936597.jpg,0,0,15,76,13,104
8593005656.jpg,2,23,74,9,0,108
8595112756.jpg,0,0,23,75,4,102
8595244033.jpg,0,0,26,72,4,102
8595845896.jpg,0,9,76,21,0,106
8595948410.jpg,8,63,29,5,0,105
8596148572.jpg,0,7,61,32,0,100
8596349698.jpg,0,0,18,80,4,102
8596361580.jpg,0,0,49,52,3,104
8596901738.jpg,4,70,33,1,0,108
8596963541.jpg,4,38,56,7,0,105
8596983746.jpg,0,1,37,63,6,107
8597007982.jpg,0,4,52,49,2,107
8597381500.jpg,0,3,62,46,0,111
8599488070.jpg,0,11,76,18,1,106
8599891034.jpg,0,6,63,40,1,110
859991088.jpg,47,61,1,0,0,109
8600036440.jpg,4,38,59,4,0,105
8600322713.jpg,0,2,35,64,2,103
8600472805.jpg,0,4,33,61,4,102
8600489475.jpg,0,2,43,61,0,106
8600504349.jpg,0,10,60,33,0,103
8600750192.jpg,4,63,35,6,0,108
8601119886.jpg,0,1,55,47,2,105
8601680123.jpg,0,23,62,16,0,101
8602273631.jpg,0,13,60,33,1,107
8602435402.jpg,0,0,23,79,6,108
8602839124.jpg,1,36,66,3,0,106
8604323835.jpg,0,3,49,49,0,101
8604870622.jpg,0,1,28,72,4,105
8606964079.jpg,0,3,43,60,1,107
8607324496.jpg,0,32,60,13,0,105
8607422328.jpg,15,86,6,0,0,107
8607616136.jpg,2,47,51,8,0,108
8608196738.jpg,0,4,57,42,0,103
8608242752.jpg,0,0,27,68,5,100
8608282741.jpg,0,1,35,66,6,108
8608557464.jpg,0,2,65,39,0,106
8610015449.jpg,0,1,49,51,0,101
8610505282.jpg,0,0,17,88,5,110
8610523080.jpg,0,9,70,26,0,105
8610701081.jpg,0,1,20,86,5,112
8610965034.jpg,0,1,24,71,11,107
8611793668.jpg,0,1,58,50,2,111
8612503268.jpg,0,1,46,48,5,100
8613516565.jpg,0,0,28,77,3,108
8613815314.jpg,0,11,53,41,1,106
8615148214.jpg,0,4,60,45,1,110
8615756718.jpg,0,6,65,29,0,100
8616342001.jpg,34,51,21,0,0,106
8616708613.jpg,6,77,26,0,0,109
8616750908.jpg,38,70,2,0,0,110
8617030862.jpg,0,0,44,58,3,105
8617343673.jpg,0,0,28,76,3,107
8617452211.jpg,0,8,67,31,0,106
8617517082.jpg,0,1,33,70,5,109
8617920561.jpg,0,9,59,31,1,100
8618147512.jpg,0,1,56,50,0,107
8618789190.jpg,0,2,34,67,0,103
8619398770.jpg,0,11,64,27,0,102
8619422796.jpg,0,2,55,45,0,102
8620686347.jpg,0,16,65,25,1,107
8620919369.jpg,1,63,74,2,0,140
8623218161.jpg,0,0,19,86,2,107
8623527706.jpg,3,9,80,21,0,113
86243803.jpg,4,44,45,6,0,99
8625160006.jpg,3,41,48,7,1,100
8626678643.jpg,0,2,57,41,1,101
8626945283.jpg,6,14,55,28,4,107
8627391076.jpg,0,0,42,60,2,104
8627453045.jpg,0,0,24,71,6,101
8627956046.jpg,0,2,30,74,2,108
8628548669.jpg,0,3,51,52,1,107
8629754639.jpg,0,10,76,22,0,108
8629854370.jpg,0,0,37,74,2,113
8630845484.jpg,3,44,58,5,1,111
8631292769.jpg,0,1,46,54,1,102
8631436677.jpg,0,0,38,65,0,103
8632003704.jpg,2,13,57,36,2,110
8632135169.jpg,2,36,55,10,1,104
8633987600.jpg,0,3,57,43,1,104
8634101418.jpg,0,5,59,41,0,105
8634276040.jpg,1,40,53,8,0,102
8634679976.jpg,1,6,60,35,1,103
8634744119.jpg,0,0,31,67,3,101
8635239066.jpg,0,1,55,49,1,106
8636582269.jpg,0,0,32,72,2,106
8636633195.jpg,0,0,48,58,1,107
8636811972.jpg,0,1,38,64,6,109
8636833629.jpg,6,80,22,0,0,108
8637618858.jpg,0,2,39,57,1,99
8638507719.jpg,0,2,41,57,3,103
8638666116.jpg,0,3,40,59,1,103
8639628841.jpg,0,2,40,61,3,106
8639669088.jpg,0,3,55,52,3,113
8639759293.jpg,0,1,39,60,2,102
8639811289.jpg,0,0,14,87,11,112
8639919087.jpg,0,16,65,22,0,103
8639922039.jpg,0,11,57,36,0,104
8640408375.jpg,0,3,56,43,1,103
8640671500.jpg,1,2,62,36,2,103
8641316746.jpg,0,6,106,33,0,145
8641533130.jpg,0,9,68,28,1,106
8642082647.jpg,7,58,29,3,0,97
8642168798.jpg,0,4,57,44,0,105
8642423630.jpg,1,5,49,52,3,110
8642430238.jpg,0,3,47,48,9,107
8644125724.jpg,0,4,59,38,1,102
8644207930.jpg,21,59,25,0,0,105
8644363471.jpg,0,4,47,84,4,139
8644395037.jpg,1,33,87,19,0,140
8644571098.jpg,0,1,22,69,10,102
8644731627.jpg,0,4,64,37,0,105
8644935134.jpg,0,2,60,39,0,101
8645014360.jpg,2,37,63,7,0,109
8645679476.jpg,0,1,10,95,7,113
8645856155.jpg,0,3,74,34,0,111
8645919775.jpg,0,1,53,48,1,103
8645927718.jpg,0,2,32,71,2,107
8646019769.jpg,0,4,67,52,0,123
8646711055.jpg,0,1,46,49,7,103
8647121069.jpg,0,2,47,63,0,112
8647880189.jpg,0,0,51,58,1,110
8648111033.jpg,1,24,69,18,0,112
8648273876.jpg,0,1,20,77,2,100
8650038281.jpg,0,5,58,38,0,101
8650041199.jpg,0,1,24,81,5,111
8650438745.jpg,0,0,30,66,1,97
8650937010.jpg,1,5,75,26,0,107
8651960690.jpg,1,12,48,41,0,102
8652814108.jpg,1,48,49,3,0,101
8653060124.jpg,0,27,65,12,0,104
8653149698.jpg,0,10,51,47,2,110
8653385211.jpg,0,2,34,60,2,98
86543550.jpg,0,4,46,49,7,106
8654833683.jpg,0,2,66,30,0,98
8655212711.jpg,0,6,62,39,1,108
8655538784.jpg,25,73,3,0,0,101
8657980323.jpg,0,1,30,68,4,103
8658407746.jpg,0,4,57,46,1,108
8658742127.jpg,0,3,21,76,5,105
8659008037.jpg,0,2,45,64,0,111
8660939599.jpg,0,2,45,57,0,104
8661391867.jpg,2,11,71,25,0,109
8663368144.jpg,0,0,39,68,1,108
8664375707.jpg,0,7,55,44,1,107
8665123695.jpg,0,5,72,40,3,120
8665859306.jpg,0,8,72,34,0,114
8666962145.jpg,0,10,62,32,1,105
8667121921.jpg,0,1,50,57,0,108
8667622533.jpg,0,0,19,86,1,106
8667640386.jpg,40,66,5,0,0,111
8667761330.jpg,0,7,40,54,0,101
8668135949.jpg,2,18,58,27,0,105
8668194198.jpg,0,4,57,43,0,104
8668357579.jpg,0,3,66,37,1,107
8668432915.jpg,0,2,56,74,7,139
8668692139.jpg,1,44,55,1,0,101
8668839930.jpg,0,2,47,49,3,101
8669455182.jpg,1,24,67,10,0,102
8669765013.jpg,1,8,69,24,0,102
8669807326.jpg,0,11,63,39,0,113
8669827233.jpg,0,2,63,43,1,109
8669875850.jpg,0,0,13,71,25,109
8669987529.jpg,27,61,15,0,0,103
8670498239.jpg,0,4,32,62,2,100
8670524662.jpg,0,5,64,36,0,105
8671346109.jpg,0,6,75,23,0,104
8672886430.jpg,0,2,30,88,7,127
8673060245.jpg,0,1,34,65,5,105
8673410143.jpg,0,1,13,72,20,106
8674617206.jpg,1,24,69,14,0,108
8675618794.jpg,2,40,54,7,0,103
8675742263.jpg,0,0,34,65,4,103
8676061963.jpg,0,3,74,32,0,109
8676415201.jpg,0,4,50,46,3,103
8676993848.jpg,0,0,36,61,1,98
8677186401.jpg,0,9,63,39,0,111
8679754087.jpg,2,16,62,30,0,110
8680382358.jpg,0,2,34,64,9,109
8681619509.jpg,0,11,73,23,0,107
8683573016.jpg,1,7,66,34,0,108
8683910174.jpg,2,34,59,6,0,101
8684784453.jpg,0,2,48,60,1,111
8686047954.jpg,0,0,26,70,6,102
8687168552.jpg,0,2,54,46,0,102
8687755587.jpg,0,10,95,21,0,126
8688105270.jpg,0,0,27,70,4,101
8688570494.jpg,0,0,21,83,9,113
8688672632.jpg,0,0,17,77,11,105
8690378205.jpg,0,3,46,54,1,104
8691429186.jpg,0,1,38,70,1,110
8691629871.jpg,0,36,59,12,0,107
8691658021.jpg,0,0,38,63,1,102
8692247074.jpg,1,0,35,84,5,125
8693045087.jpg,0,0,7,90,15,112
8693359675.jpg,0,14,81,12,0,107
869382458.jpg,2,23,73,13,0,111
8693865711.jpg,0,0,29,69,8,106
8695646882.jpg,0,0,18,78,12,108
8695656651.jpg,2,54,42,2,0,100
8696013314.jpg,0,7,55,44,2,108
8696567124.jpg,3,60,39,1,0,103
8697211336.jpg,0,0,28,73,6,107
8697364440.jpg,0,2,61,45,0,108
8697765454.jpg,0,57,42,1,0,100
8698328366.jpg,0,2,42,59,2,105
8699039377.jpg,0,1,22,81,6,110
8700100428.jpg,0,0,22,84,4,110
8701800150.jpg,0,2,35,61,5,103
8701957904.jpg,0,3,66,35,1,105
8702092556.jpg,0,0,43,62,2,107
8702450132.jpg,1,17,85,23,0,126
8702518420.jpg,0,0,27,73,6,106
8702530063.jpg,0,2,54,47,0,103
8702541866.jpg,0,1,46,55,2,104
8702657469.jpg,11,66,24,2,0,103
8703113665.jpg,1,43,57,8,0,109
8703657043.jpg,0,4,59,38,0,101
8703680136.jpg,15,56,34,4,0,109
8703712845.jpg,0,8,98,21,0,127
8704001812.jpg,0,0,38,65,2,105
8704133333.jpg,0,2,32,61,5,100
8705060352.jpg,1,33,64,11,0,109
8705536207.jpg,0,53,50,10,0,113
8706343716.jpg,0,3,83,23,0,109
8706810197.jpg,0,2,37,65,6,110
8707214366.jpg,1,0,16,78,10,105
8707676839.jpg,0,32,64,8,0,104
8709304294.jpg,8,85,17,0,0,110
8709597894.jpg,0,2,45,54,2,103
8709697980.jpg,0,0,47,50,3,100
8710250301.jpg,0,4,71,79,1,155
8710431611.jpg,0,2,37,57,6,102
8711977206.jpg,0,3,79,45,0,127
8713381356.jpg,1,45,47,4,0,97
8713537516.jpg,0,15,62,30,0,107
8714823724.jpg,0,2,42,57,2,103
8715170978.jpg,0,23,111,16,0,150
8715241935.jpg,0,7,67,39,0,113
8715401905.jpg,18,71,12,0,0,101
8715753944.jpg,0,0,43,65,3,111
8716882404.jpg,0,1,49,56,1,107
8717130944.jpg,0,4,36,67,7,114
8717637188.jpg,0,1,20,76,0,97
8718552383.jpg,0,3,35,66,3,107
8718592525.jpg,0,4,36,61,5,106
8718842570.jpg,1,14,60,25,0,100
8720193519.jpg,8,43,51,7,0,109
872022815.jpg,4,74,22,0,0,100
8721056397.jpg,36,69,3,0,0,108
8722198954.jpg,0,10,74,28,0,112
8723579314.jpg,0,1,59,61,0,121
8724425373.jpg,0,8,64,26,4,102
8724561762.jpg,1,2,41,55,4,103
8724954192.jpg,4,38,54,10,0,106
8725613522.jpg,5,71,29,3,0,108
8726161561.jpg,0,2,36,64,5,107
8726378587.jpg,0,0,24,66,7,97
8727344040.jpg,0,2,20,76,5,103
8727585507.jpg,0,7,77,21,0,105
8728469348.jpg,0,2,61,47,0,110
8728473663.jpg,0,6,45,54,0,105
8728715575.jpg,0,0,18,72,12,102
8728752853.jpg,0,1,57,48,0,106
8729158424.jpg,0,5,43,55,6,109
8729980010.jpg,0,4,41,53,3,101
8730092034.jpg,0,1,17,85,6,109
8730533258.jpg,0,1,32,71,8,112
8730747598.jpg,2,39,58,3,0,102
8730988705.jpg,0,0,25,69,8,102
8731143356.jpg,0,8,48,46,1,103
8731562113.jpg,0,6,61,43,0,110
8731687035.jpg,2,38,62,5,0,107
8731705218.jpg,0,0,32,69,6,107
8732282616.jpg,0,5,54,42,0,101
8732397324.jpg,10,74,21,0,0,105
8732646741.jpg,0,17,73,18,0,108
8732953050.jpg,0,1,32,76,2,111
8733519611.jpg,1,0,40,60,1,102
8733562507.jpg,0,2,37,65,4,108
8733728144.jpg,0,1,38,60,5,104
8734847489.jpg,0,9,60,43,1,113
8735700380.jpg,0,1,32,69,1,103
8736095629.jpg,0,1,44,60,0,105
8736395579.jpg,0,1,50,52,2,105
873682751.jpg,4,52,47,7,0,110
8736879292.jpg,0,5,75,26,1,107
8737972385.jpg,0,1,48,50,3,102
8742280365.jpg,0,17,84,23,0,124
8742323176.jpg,1,18,62,27,0,108
8743944148.jpg,2,63,38,1,0,104
8745291792.jpg,0,1,20,80,2,103
8745953241.jpg,0,14,60,24,2,100
8746191422.jpg,0,1,16,85,2,104
8746457937.jpg,3,28,63,10,1,105
8746542465.jpg,0,2,38,83,4,127
8746881284.jpg,0,43,54,6,0,103
8746934807.jpg,0,34,64,9,0,107
8748661037.jpg,0,12,75,19,0,106
8749825399.jpg,0,0,24,70,8,102
8749890133.jpg,0,1,30,75,4,110
8750299747.jpg,5,64,39,2,0,110
8750929874.jpg,1,10,45,46,0,102
8751039261.jpg,0,0,36,75,2,113
8751065602.jpg,0,3,48,55,0,106
8751106130.jpg,0,2,59,71,0,132
87511338.jpg,4,78,23,1,0,106
8751458979.jpg,0,3,47,51,2,103
8751762111.jpg,0,0,32,68,0,100
8751989930.jpg,14,88,7,0,0,109
8754025405.jpg,0,0,22,72,11,105
8754056878.jpg,0,0,41,63,2,106
8755395714.jpg,0,0,31,72,2,105
8755673278.jpg,0,0,59,46,0,105
8755824682.jpg,0,0,27,69,3,99
8756419280.jpg,0,7,66,28,3,104
8757692529.jpg,1,8,72,24,1,106
8762864048.jpg,0,13,64,36,0,113
8768474112.jpg,20,70,22,2,0,114
8771756230.jpg,25,68,9,0,0,102
8772955624.jpg,0,0,17,85,7,109
8774523686.jpg,0,1,30,69,6,106
8776151757.jpg,0,3,65,37,2,107
8779946210.jpg,0,0,26,70,4,100
8781313469.jpg,0,0,31,73,3,107
8781992421.jpg,0,3,33,62,5,103
8787599446.jpg,0,4,52,45,1,102
8794313763.jpg,0,2,53,61,4,120
8795821243.jpg,0,0,22,79,2,103
8797772647.jpg,0,4,56,38,1,99
8800590382.jpg,0,15,98,25,0,138
8802725309.jpg,3,54,53,3,0,113
8812917559.jpg,1,19,68,20,2,110
8814635311.jpg,0,6,60,32,4,102
8816701721.jpg,1,22,69,10,0,102
8816975901.jpg,0,3,75,30,1,109
8817313814.jpg,0,0,39,70,2,111
8819567462.jpg,2,43,59,1,0,105
8821348628.jpg,0,10,44,48,2,104
8826596290.jpg,8,62,33,2,0,105
8830329798.jpg,1,38,57,6,0,102
8832426254.jpg,0,8,68,32,1,109
8836006786.jpg,0,0,42,62,0,104
8840187174.jpg,72,33,2,0,0,107
8841313273.jpg,0,4,21,74,3,102
8841877925.jpg,0,3,27,67,6,103
8844582694.jpg,1,26,64,15,0,106
8844729886.jpg,0,2,39,60,1,102
8848421856.jpg,0,15,63,30,0,108
8850126806.jpg,1,30,71,6,0,108
8850392186.jpg,3,30,71,4,0,108
885060581.jpg,1,10,62,27,1,101
8851705236.jpg,9,72,20,1,0,102
8853329035.jpg,0,3,66,41,1,111
8856278655.jpg,0,7,67,28,0,102
8858418581.jpg,0,0,9,79,11,99
8859569385.jpg,0,0,26,78,2,106
8860399629.jpg,3,50,62,3,0,118
8862366940.jpg,0,11,60,35,0,106
8863356627.jpg,0,2,66,28,0,96
8864018641.jpg,0,6,54,50,0,110
8866395362.jpg,0,5,48,49,2,104
8867729088.jpg,0,2,56,47,1,106
8871477031.jpg,43,65,3,0,0,111
8872523602.jpg,0,2,57,45,0,104
8877114673.jpg,3,72,34,2,0,111
8877350801.jpg,3,38,51,8,1,101
8878353214.jpg,0,5,73,47,0,125
8880556755.jpg,2,48,54,5,0,109
8880877335.jpg,0,0,38,60,5,103
8882534571.jpg,4,35,64,10,0,113
8883794004.jpg,0,5,78,24,0,107
8883829297.jpg,0,11,58,35,1,105
8884240572.jpg,0,2,43,56,2,103
8885623781.jpg,0,3,31,65,1,100
8886401995.jpg,0,2,34,60,1,97
8890374321.jpg,0,3,32,70,1,106
8891540889.jpg,0,2,45,57,1,105
8891817478.jpg,0,57,47,3,0,107
8891882667.jpg,0,0,30,69,3,102
8892359151.jpg,1,14,72,19,0,106
8893986467.jpg,1,3,36,57,3,100
8894308933.jpg,0,1,14,79,12,106
8895109111.jpg,2,32,57,13,0,104
8896534535.jpg,0,4,62,38,1,105
8897373737.jpg,0,3,30,67,4,104
8899231880.jpg,3,45,56,0,0,104
8901015763.jpg,0,36,68,3,0,107
8902141836.jpg,2,45,57,3,0,107
8902189112.jpg,0,3,33,63,1,100
890231750.jpg,0,29,67,12,0,108
8902840150.jpg,1,8,58,33,0,100
8904864157.jpg,0,2,65,66,0,133
8904883731.jpg,1,1,40,64,2,108
8905578199.jpg,0,0,27,70,6,103
8906347187.jpg,0,1,47,69,1,118
8906425755.jpg,0,48,50,5,0,103
8909034593.jpg,0,0,23,73,10,106
8909361776.jpg,0,2,48,56,0,106
8910371075.jpg,0,0,30,67,1,98
8911365579.jpg,1,30,61,9,0,101
8911411937.jpg,0,1,31,68,6,106
8911730034.jpg,0,14,80,36,0,130
8914830252.jpg,0,4,45,58,1,108
8916793773.jpg,0,1,26,72,6,105
8916833328.jpg,0,11,74,20,0,105
8918860577.jpg,0,56,50,3,0,109
8918997719.jpg,0,11,59,33,0,103
8919875155.jpg,0,21,72,13,0,106
8921955477.jpg,0,1,45,63,0,109
8923165653.jpg,0,11,68,24,0,103
8924220861.jpg,0,0,35,66,4,105
8925642155.jpg,0,2,52,53,0,107
8925668401.jpg,0,0,27,74,8,109
8925875609.jpg,0,0,24,73,5,102
8928315797.jpg,0,3,42,54,3,102
8929337311.jpg,0,8,61,31,1,101
8929900709.jpg,0,4,60,37,2,103
8930021210.jpg,1,13,59,30,0,103
8930347179.jpg,0,0,30,73,4,107
8930562482.jpg,0,3,62,40,1,106
8930722689.jpg,0,12,66,26,1,105
8930797229.jpg,0,0,13,85,3,101
8933281660.jpg,0,16,89,30,0,135
8933319583.jpg,4,89,51,0,0,144
8933855427.jpg,0,16,63,25,1,105
8935735197.jpg,0,8,52,42,5,107
8935938604.jpg,0,6,52,50,0,108
8936501287.jpg,14,73,17,3,0,107
8937929358.jpg,0,56,37,2,0,95
8938035476.jpg,0,2,42,53,4,101
8938472188.jpg,21,100,25,0,0,146
89393627.jpg,17,66,20,0,0,103
8939389375.jpg,0,0,8,83,19,110
8939732555.jpg,37,71,5,0,0,113
8940969671.jpg,0,0,23,74,10,107
8941443262.jpg,0,1,57,40,2,100
8942422332.jpg,0,1,33,62,4,100
8943413727.jpg,0,5,66,53,2,126
8944011983.jpg,16,68,19,2,0,105
8946027655.jpg,0,5,65,70,1,141
8948115296.jpg,0,18,74,13,0,105
8950318830.jpg,0,0,20,66,15,101
8960852902.jpg,0,4,57,40,0,101
8962032549.jpg,0,3,52,51,0,106
8965909066.jpg,0,5,53,59,3,120
8968242975.jpg,16,71,23,1,0,111
8970460328.jpg,1,10,59,39,0,109
8970878075.jpg,0,4,62,35,1,102
8971376273.jpg,0,0,30,73,4,107
8972898508.jpg,23,60,23,3,0,109
8973350530.jpg,0,4,42,49,5,100
8974114251.jpg,0,5,73,29,0,107
8975077146.jpg,0,1,34,76,0,111
8975567714.jpg,0,1,25,71,7,104
8975620960.jpg,2,17,73,12,0,104
8975860650.jpg,0,0,9,81,20,110
8977825134.jpg,0,38,62,9,0,109
8978679476.jpg,0,12,56,34,4,106
898061275.jpg,0,2,43,86,4,135
8984346211.jpg,0,1,37,60,0,98
8984699375.jpg,0,12,77,16,0,105
8985407469.jpg,0,10,48,50,0,108
8985551582.jpg,5,53,43,10,0,111
8986202022.jpg,0,2,45,60,1,108
8986260148.jpg,0,2,36,68,1,107
8986464809.jpg,0,0,11,75,15,101
8986471316.jpg,1,38,66,3,0,108
8987485650.jpg,3,34,57,9,0,103
8988143845.jpg,0,3,62,37,1,103
8988227086.jpg,0,10,71,21,0,102
8988404310.jpg,4,31,65,7,0,107
8988892733.jpg,0,0,25,80,1,106
899304128.jpg,0,4,69,35,0,108
8994347098.jpg,0,3,37,57,15,112
8995226934.jpg,0,0,15,80,6,101
8997198808.jpg,0,0,29,74,2,105
8998348605.jpg,0,4,45,51,0,100
8999325582.jpg,0,0,35,66,4,105
9000701354.jpg,0,2,30,70,5,107
9002014430.jpg,0,4,49,53,2,108
9002438378.jpg,0,3,55,67,1,126
9003236001.jpg,0,13,40,57,1,111
9004727133.jpg,0,0,23,77,5,105
9005613417.jpg,0,7,59,37,5,108
9005619499.jpg,0,4,38,58,7,107
9007177518.jpg,0,3,71,55,2,131
9016164225.jpg,0,0,47,56,3,106
9016868192.jpg,0,2,53,54,1,110
9017247850.jpg,0,6,74,19,0,99
9018209858.jpg,1,47,58,5,0,111
9019428727.jpg,0,1,50,50,0,101
9021392547.jpg,1,42,51,8,0,102
9021755853.jpg,0,0,82,51,0,133
9027689601.jpg,0,35,64,10,0,109
9028566654.jpg,0,1,41,56,2,100
9029384629.jpg,14,111,31,0,0,156
9029712750.jpg,0,1,37,62,4,104
9032729328.jpg,0,20,74,18,0,112
9034047597.jpg,0,3,56,43,2,104
9034707954.jpg,0,19,64,26,0,109
9034716133.jpg,0,1,25,80,1,107
9034987420.jpg,36,67,2,0,0,105
9036022986.jpg,0,3,54,46,1,104
9036180286.jpg,0,1,42,63,2,108
9036594264.jpg,0,15,67,24,1,107
9037387298.jpg,0,2,42,64,1,109
9037452749.jpg,4,62,37,0,0,103
9038457719.jpg,0,8,72,23,1,104
9038497618.jpg,0,4,55,40,1,100
9041103039.jpg,0,25,54,27,0,106
9042624878.jpg,0,0,13,89,4,106
9046007138.jpg,0,2,43,85,4,134
9047016405.jpg,0,5,68,31,1,105
904761358.jpg,2,25,67,7,0,101
9048453025.jpg,0,0,12,83,14,109
9049275396.jpg,0,3,41,56,2,102
9050414795.jpg,0,1,36,64,4,105
9050865219.jpg,0,3,31,73,0,107
9052518863.jpg,0,20,72,16,0,108
9053743376.jpg,0,2,48,52,0,102
9054377711.jpg,0,0,41,63,0,104
9055579014.jpg,0,4,36,61,2,103
9055879747.jpg,0,14,71,12,0,97
9058001335.jpg,0,10,75,23,1,109
9058722713.jpg,0,9,76,21,1,107
9058863840.jpg,1,42,57,9,0,109
9059681059.jpg,0,3,42,51,0,96
9060697338.jpg,0,10,74,22,0,106
9060994605.jpg,0,2,51,57,4,114
9061831747.jpg,3,52,42,3,0,100
9062040259.jpg,1,10,58,34,2,105
9063333592.jpg,2,39,61,3,0,105
9063924933.jpg,0,1,40,66,0,107
9064490305.jpg,0,1,44,60,0,105
9064913927.jpg,1,41,63,6,0,111
9065372715.jpg,0,3,26,99,10,138
9065857613.jpg,0,1,64,45,1,111
9066761491.jpg,0,3,53,43,1,100
9068148685.jpg,0,1,68,35,0,104
9069424514.jpg,0,8,72,18,0,98
9069849690.jpg,0,4,62,39,1,106
9070049178.jpg,0,0,36,61,3,100
9071921017.jpg,0,9,63,30,1,103
9071963923.jpg,0,0,18,82,5,105
9072067933.jpg,0,0,29,74,9,112
9072958869.jpg,0,0,40,62,1,103
9074183822.jpg,4,54,48,4,0,110
9076304306.jpg,3,66,36,1,0,106
9076672562.jpg,0,5,77,25,0,107
9079493649.jpg,0,0,29,73,2,104
9080769054.jpg,2,38,61,4,0,105
9081876401.jpg,0,1,43,60,3,107
9083308350.jpg,3,24,82,19,0,128
90834437.jpg,0,0,11,65,23,99
9090441923.jpg,0,1,42,52,1,96
9093638609.jpg,12,84,14,0,0,110
9094228395.jpg,0,8,54,40,1,103
9096574214.jpg,0,2,66,37,1,106
9098295579.jpg,0,2,30,70,5,107
9101418859.jpg,0,5,37,55,5,102
9101482614.jpg,0,2,52,55,0,109
9102604497.jpg,0,50,52,3,0,105
9102888066.jpg,0,0,16,69,22,107
9106148302.jpg,0,1,49,79,0,129
910637798.jpg,2,29,64,10,0,105
9108357145.jpg,1,40,55,6,0,102
9109124057.jpg,0,2,59,42,1,104
9109271301.jpg,0,1,42,60,2,105
9109755543.jpg,20,63,23,1,0,107
9111310939.jpg,0,0,34,69,4,107
9111487897.jpg,0,1,32,58,9,100
9112120569.jpg,1,4,51,48,1,105
9112424025.jpg,0,11,53,39,3,106
9113486865.jpg,0,0,21,76,3,100
9115676276.jpg,0,2,44,54,1,101
9118228667.jpg,0,0,54,59,1,114
9118386163.jpg,0,9,96,45,1,151
9119225606.jpg,1,0,29,79,2,111
9119961649.jpg,0,0,6,88,10,104
9119996222.jpg,1,7,80,40,0,128
9121896285.jpg,0,6,75,21,2,104
9122090851.jpg,5,35,46,10,1,97
9122758028.jpg,0,0,43,78,5,126
9122759800.jpg,0,1,36,61,3,101
9125517985.jpg,1,39,54,10,1,105
9130413555.jpg,0,31,67,10,0,108
9130643186.jpg,0,0,31,101,1,133
9130908149.jpg,0,4,67,37,1,109
9131467707.jpg,0,5,42,51,6,104
9131531714.jpg,0,0,11,77,17,105
9131687822.jpg,0,1,28,74,2,105
9132059359.jpg,0,16,72,20,0,108
9132353816.jpg,0,5,54,39,1,99
9135317445.jpg,14,78,15,0,0,107
91357025.jpg,0,5,53,45,0,103
9136502604.jpg,0,0,36,68,3,107
9136754533.jpg,0,6,62,30,2,100
9138793182.jpg,33,68,3,0,0,104
9139175955.jpg,1,7,70,31,2,111
9139430214.jpg,2,12,74,14,0,102
9140727598.jpg,0,1,44,57,2,104
9141403760.jpg,0,7,57,36,2,102
9141646333.jpg,16,48,41,8,0,113
9141930190.jpg,0,8,68,30,2,108
9141979363.jpg,0,2,84,45,0,131
9142684025.jpg,0,0,36,71,1,108
9143291063.jpg,0,1,21,83,2,107
9143757717.jpg,0,11,72,16,1,100
9145211353.jpg,3,53,60,13,0,129
9146239672.jpg,0,4,52,48,3,107
9150255535.jpg,0,3,18,68,12,101
9154088552.jpg,0,1,45,55,4,105
9154784652.jpg,0,2,40,64,2,108
9154855025.jpg,0,46,54,7,0,107
9156115930.jpg,3,40,48,13,0,104
9157119271.jpg,0,1,49,51,1,102
9159337218.jpg,0,3,31,67,9,110
9162044260.jpg,0,2,27,71,5,105
9162580665.jpg,0,2,40,56,3,101
9163113923.jpg,0,2,55,52,2,111
9164359125.jpg,0,4,64,34,0,102
9166557972.jpg,0,1,45,60,1,107
9166594378.jpg,0,5,56,45,0,106
9166911645.jpg,0,5,72,35,0,112
9170799378.jpg,0,0,34,72,1,107
9175070760.jpg,0,7,78,23,0,108
9176321809.jpg,0,1,52,48,0,101
9178485751.jpg,0,12,92,35,0,139
9179494563.jpg,0,2,72,38,0,112
9183486925.jpg,14,71,23,0,0,108
9184965477.jpg,0,5,70,36,1,112
9185475668.jpg,0,2,63,41,0,106
9185478102.jpg,3,40,49,9,0,101
9186366283.jpg,0,9,59,33,1,102
9188365433.jpg,9,77,19,0,0,105
9188509301.jpg,0,1,32,72,1,106
9191266611.jpg,0,3,40,59,2,104
9194756449.jpg,0,35,66,8,0,109
9195069146.jpg,0,0,31,67,8,106
9195323524.jpg,1,33,72,5,0,111
9195654667.jpg,2,15,52,26,4,99
9197349207.jpg,0,12,62,26,1,101
9198766588.jpg,0,0,39,64,6,109
9198779264.jpg,1,39,64,6,0,110
9200093125.jpg,0,3,57,38,0,98
9200829224.jpg,0,0,38,63,1,102
9201324227.jpg,0,4,42,54,3,103
9201555712.jpg,0,0,21,88,3,112
9202257544.jpg,0,6,56,35,3,100
9202760715.jpg,0,1,44,59,1,105
9202851539.jpg,0,2,58,46,0,106
9205194326.jpg,0,17,83,41,1,142
9206978293.jpg,0,0,36,73,1,110
9209619689.jpg,0,4,46,51,2,103
9210757941.jpg,1,21,83,2,0,107
9211639075.jpg,0,0,18,80,5,103
9211753203.jpg,11,69,25,0,0,105
9211913717.jpg,50,56,4,1,0,111
9211948856.jpg,0,13,67,19,1,100
9212037816.jpg,0,8,34,57,6,105
9212610328.jpg,0,1,32,73,3,109
9213073517.jpg,1,8,59,34,0,102
9213666869.jpg,0,4,66,27,0,97
9214795039.jpg,8,65,27,1,0,101
9215122110.jpg,1,39,58,4,0,102
9215295027.jpg,0,3,47,57,0,107
9215861266.jpg,0,9,78,19,0,106
9216910965.jpg,0,6,57,40,0,103
9217457237.jpg,0,0,33,67,2,102
9220351854.jpg,0,4,65,37,1,107
9220693447.jpg,0,8,54,38,1,101
9220941622.jpg,0,0,27,70,6,103
9221345159.jpg,0,5,63,38,2,108
9222727460.jpg,2,30,60,10,0,102
9223641047.jpg,0,27,70,13,0,110
9224664940.jpg,7,58,37,4,0,106
9225485643.jpg,0,9,60,38,0,107
9225734576.jpg,0,2,55,53,0,110
9225878690.jpg,1,20,70,21,0,112
9226793819.jpg,11,64,26,3,0,104
9226799273.jpg,0,26,74,5,0,105
9229803299.jpg,0,18,76,5,0,99
9230199139.jpg,2,12,55,36,1,106
9230996141.jpg,0,1,32,68,4,105
92317233.jpg,18,64,17,1,0,100
9232225621.jpg,0,3,52,50,0,105
9232371989.jpg,7,71,52,4,0,134
9232503869.jpg,4,67,31,0,0,102
9232794108.jpg,0,0,29,68,3,100
92336148.jpg,0,8,39,57,2,106
9234807959.jpg,0,24,76,5,0,105
9237243302.jpg,31,57,14,3,0,105
9237285028.jpg,0,5,72,19,1,97
9237488355.jpg,0,0,34,88,3,125
9238616212.jpg,0,3,39,66,5,113
9239005893.jpg,0,0,40,65,3,108
9239862860.jpg,1,3,53,46,2,105
9240332205.jpg,0,3,57,40,0,100
9240392822.jpg,0,3,46,47,5,101
9241531106.jpg,0,2,26,72,5,105
9242083882.jpg,0,2,62,61,2,127
9244573247.jpg,0,22,69,8,0,99
9245144961.jpg,0,7,70,27,0,104
9245259823.jpg,0,2,44,59,0,105
9246527762.jpg,6,65,35,1,0,107
92466227.jpg,2,36,47,18,1,104
9246656735.jpg,0,4,43,49,6,102
9248275667.jpg,0,6,72,30,0,108
9249272493.jpg,0,1,18,92,3,114
9249859612.jpg,0,2,55,45,0,102
9249869281.jpg,27,66,8,0,0,101
9251039345.jpg,0,2,47,51,1,101
9251645143.jpg,0,1,48,55,4,108
9253116202.jpg,0,0,38,67,3,108
9255279783.jpg,0,3,40,56,8,107
9256298469.jpg,0,3,41,62,0,106
9256620726.jpg,0,1,17,72,18,108
9257237144.jpg,1,12,75,21,0,109
9257583469.jpg,0,0,17,81,5,103
9258012910.jpg,0,0,21,79,6,106
9258059092.jpg,0,9,65,73,8,155
9259054228.jpg,0,3,61,41,2,107
9262147694.jpg,0,9,87,10,0,106
9263759875.jpg,0,0,39,65,4,108
9264499657.jpg,38,67,4,0,0,109
9264744599.jpg,0,10,57,33,1,101
9265274583.jpg,1,21,61,20,0,103
9265763356.jpg,2,19,51,29,1,102
9267882389.jpg,0,1,34,80,3,118
9269067450.jpg,2,47,43,9,0,101
9269195837.jpg,1,4,61,45,0,111
9269537075.jpg,0,1,23,74,9,107
9274541718.jpg,0,7,67,28,0,102
9274677525.jpg,0,13,71,24,1,109
9277184417.jpg,0,20,72,17,0,109
9281657562.jpg,0,0,36,70,2,108
9283219931.jpg,0,2,57,43,0,102
9283273348.jpg,0,3,30,68,6,107
9283322341.jpg,0,0,31,71,3,105
9284536346.jpg,0,2,54,53,0,109
9284861098.jpg,0,4,50,52,3,109
9286263885.jpg,0,23,74,6,0,103
9286580231.jpg,0,3,60,44,2,109
9287500291.jpg,0,3,49,59,0,111
9289816970.jpg,5,60,36,3,0,104
9290273110.jpg,1,25,68,11,0,105
9290321332.jpg,0,4,45,53,4,106
9291621754.jpg,0,2,63,32,0,97
9294636383.jpg,10,61,24,0,0,95
9295408685.jpg,1,11,95,25,0,132
9297541584.jpg,0,19,57,33,0,109
9297933012.jpg,2,54,46,3,0,105
9298572085.jpg,0,0,28,80,3,111
9299238943.jpg,1,31,59,18,0,109
9301174145.jpg,0,2,56,43,0,101
9301597304.jpg,6,65,40,1,0,112
9302290265.jpg,0,3,61,43,1,108
9303678528.jpg,0,22,80,6,0,108
9304089120.jpg,0,0,25,71,6,102
9304302078.jpg,0,0,54,44,1,99
9304786049.jpg,0,0,32,70,0,102
930643510.jpg,18,79,10,0,0,107
9306814074.jpg,0,0,31,77,3,111
9307347958.jpg,12,72,18,0,0,102
9309381016.jpg,0,9,53,41,1,104
9310356178.jpg,0,6,72,27,0,105
9314256771.jpg,0,6,42,58,1,107
9315620500.jpg,0,4,64,70,0,138
9317715562.jpg,3,22,73,8,0,106
9318049470.jpg,0,0,40,65,1,106
9318914214.jpg,5,20,59,26,0,110
9321343770.jpg,0,3,31,75,2,111
9322027317.jpg,1,8,73,26,0,108
9322601223.jpg,0,3,70,66,1,140
9324301658.jpg,0,1,21,75,4,101
9324654543.jpg,1,7,89,29,0,126
9324716054.jpg,0,2,29,70,3,104
9326601195.jpg,0,3,26,67,7,103
9327556810.jpg,0,3,28,70,4,105
9327697070.jpg,1,5,52,42,3,103
9328342385.jpg,0,0,28,70,10,108
9328964042.jpg,0,12,73,21,0,106
9329940580.jpg,0,24,59,18,1,102
9331151234.jpg,1,4,42,62,3,112
9332496650.jpg,0,1,22,86,4,113
9332533553.jpg,1,10,92,37,1,141
9333294037.jpg,0,5,67,35,0,107
9333668178.jpg,0,3,30,67,5,105
9334502001.jpg,0,18,70,18,1,107
9335509582.jpg,8,87,49,2,0,146
9335639356.jpg,17,80,3,0,0,100
9336450850.jpg,0,0,12,79,14,105
9337247723.jpg,0,1,64,42,0,107
9338607155.jpg,1,13,58,30,0,102
9339023066.jpg,0,0,43,63,1,107
9339173002.jpg,0,5,74,22,0,101
9339437714.jpg,0,6,50,49,1,106
9341605084.jpg,0,0,20,86,4,110
9341616816.jpg,0,0,37,79,3,119
9342036891.jpg,1,29,57,9,0,96
9342285552.jpg,0,1,25,71,6,103
9342669344.jpg,0,2,62,47,0,111
9344271524.jpg,0,0,35,69,3,107
9344542617.jpg,5,81,25,0,0,111
9345882583.jpg,1,18,81,10,0,110
9346160455.jpg,0,1,43,59,2,105
9346372358.jpg,0,2,36,60,10,108
9346378862.jpg,0,2,36,64,2,104
9346802331.jpg,0,47,55,6,0,108
93473094.jpg,4,41,50,8,0,103
9348271980.jpg,0,0,18,79,10,107
9348876103.jpg,0,28,66,8,0,102
9349890960.jpg,0,2,27,72,3,104
935105924.jpg,0,27,90,9,0,126
9351387644.jpg,0,0,10,88,8,106
9352087961.jpg,78,32,0,0,0,110
9352825622.jpg,0,2,42,65,1,110
9353536560.jpg,1,14,80,29,0,124
9354878188.jpg,0,2,41,66,1,110
9362014571.jpg,3,36,51,10,1,101
9362231010.jpg,0,1,39,66,3,109
9363143543.jpg,0,0,59,48,1,108
9365989820.jpg,0,20,61,21,0,102
9366566723.jpg,0,2,63,38,1,104
9369620513.jpg,0,1,27,73,3,104
9369983914.jpg,0,1,44,64,1,110
9372136957.jpg,0,4,54,49,4,111
9372534946.jpg,0,10,59,34,1,104
9372862494.jpg,2,30,56,14,3,105
9373483438.jpg,0,3,52,48,0,103
9375359458.jpg,0,2,56,46,1,105
9376075949.jpg,0,3,35,60,2,100
9379310013.jpg,0,0,32,69,2,103
9379361831.jpg,0,0,24,74,6,104
9379457487.jpg,0,1,23,74,7,105
9380189805.jpg,1,0,47,55,0,103
9384228809.jpg,0,5,52,50,2,109
9387665300.jpg,0,0,23,75,11,109
9389671360.jpg,0,35,64,6,0,105
9389784838.jpg,0,1,42,58,3,104
9391288768.jpg,0,1,28,77,5,111
93917546.jpg,1,27,53,22,0,103
9393485021.jpg,0,0,18,77,6,101
9394014608.jpg,2,48,49,7,0,106
9398081258.jpg,0,3,48,44,1,96
9401118786.jpg,3,15,71,20,0,109
9401387705.jpg,0,1,27,78,2,108
9401940143.jpg,2,40,57,1,0,100
940371579.jpg,0,9,75,27,1,112
9405444471.jpg,0,2,55,46,6,109
9406497605.jpg,0,2,39,66,0,107
9406525947.jpg,0,1,40,69,1,111
9406773963.jpg,28,72,7,0,0,107
9407500904.jpg,0,14,58,28,0,100
9407500995.jpg,0,1,24,80,4,109
9408208696.jpg,0,1,23,74,5,103
9408400121.jpg,0,1,45,64,4,114
9409533366.jpg,0,3,55,44,0,102
9413392698.jpg,0,15,65,20,0,100
9416795305.jpg,0,2,33,68,3,106
9417195704.jpg,0,5,43,62,1,111
9418862819.jpg,14,55,37,2,0,108
9419143176.jpg,0,23,72,7,0,102
9419183210.jpg,0,2,37,69,3,111
9424457746.jpg,0,0,25,70,9,104
9424726743.jpg,1,16,72,14,0,103
9426505697.jpg,2,44,52,3,0,101
9427704319.jpg,0,1,26,72,2,101
9428417271.jpg,0,4,42,55,1,102
9428890222.jpg,4,44,46,14,0,108
9429089796.jpg,0,2,25,71,10,108
9432792818.jpg,2,12,50,31,5,100
9433458685.jpg,1,6,31,62,7,107
9433764311.jpg,0,0,38,83,5,126
9434602286.jpg,0,0,31,70,2,103
9434819807.jpg,0,0,8,85,8,101
9435287371.jpg,0,0,20,81,3,104
9438182965.jpg,0,0,24,60,19,103
9438332547.jpg,0,0,16,86,2,104
9438428165.jpg,1,0,21,83,1,106
9439720567.jpg,0,8,45,57,1,111
9439902792.jpg,0,2,33,64,2,101
9439964500.jpg,0,11,80,12,0,103
9442161547.jpg,0,0,33,73,3,109
944341845.jpg,1,23,102,11,0,137
9444126747.jpg,0,0,36,62,1,99
9445074981.jpg,0,1,32,77,4,114
9445529272.jpg,4,36,56,7,0,103
9450353504.jpg,8,64,53,1,0,126
9455543659.jpg,0,1,49,58,5,113
9455732786.jpg,1,31,62,11,1,106
9456887097.jpg,0,7,40,59,1,107
9457716836.jpg,0,3,31,64,2,100
9458038705.jpg,0,13,67,26,0,106
9458474537.jpg,0,11,62,28,2,103
9458721242.jpg,0,12,77,18,0,107
9458811902.jpg,0,1,38,65,2,106
9459450025.jpg,0,0,47,63,1,111
9460489511.jpg,0,0,55,50,3,108
9461924966.jpg,0,6,65,29,0,100
9462111992.jpg,0,0,18,86,6,110
9463299362.jpg,0,3,80,22,1,106
9463363154.jpg,0,4,67,34,0,105
9467289840.jpg,0,12,71,28,1,112
9467953954.jpg,0,1,24,68,10,103
9468744508.jpg,0,0,19,83,8,110
9469622762.jpg,0,11,68,22,0,101
9470847928.jpg,0,0,10,92,9,111
9471314459.jpg,0,0,38,66,2,106
9472829997.jpg,3,48,52,1,0,104
9472868070.jpg,1,8,68,31,0,108
9473084663.jpg,0,12,72,24,0,108
9474360756.jpg,0,1,39,67,1,108
9475748691.jpg,3,13,73,12,1,102
9476849940.jpg,0,2,40,61,1,104
9476907478.jpg,0,0,27,75,6,108
9477685137.jpg,0,3,54,50,0,107
9477847678.jpg,0,2,38,58,7,105
9479081195.jpg,5,56,40,1,0,102
9479870149.jpg,0,1,26,82,3,112
9480350471.jpg,0,6,74,23,0,103
9480702491.jpg,0,0,39,70,2,111
9482188665.jpg,0,0,52,56,2,110
9482512663.jpg,0,0,28,91,7,126
9482519952.jpg,0,9,70,22,0,101
9483190108.jpg,1,0,28,73,4,106
9483838441.jpg,0,1,39,93,7,140
9484887965.jpg,0,21,63,19,0,103
9484990711.jpg,8,70,27,0,0,105
9485553260.jpg,0,1,25,67,6,99
9485678546.jpg,1,32,66,8,0,107
9486578471.jpg,2,46,47,7,0,102
9487232298.jpg,0,5,53,50,0,108
9487747992.jpg,7,68,24,4,0,103
9488096665.jpg,0,1,28,66,10,105
94886803.jpg,1,2,36,56,4,99
9488864072.jpg,1,19,67,9,0,96
9489836089.jpg,0,2,44,53,1,100
9490079439.jpg,0,0,49,52,3,104
9490329837.jpg,0,1,60,46,3,110
9493293324.jpg,0,0,43,59,2,104
9494293866.jpg,7,66,31,2,0,106
9494790787.jpg,0,1,53,57,2,113
9494953335.jpg,0,2,76,70,0,148
9495726171.jpg,0,0,30,71,5,106
9496059717.jpg,0,1,49,48,4,102
9496541245.jpg,0,10,44,46,6,106
9497146011.jpg,1,13,57,28,1,100
9497710012.jpg,21,89,21,0,0,131
9497810800.jpg,0,3,73,31,1,108
9498977620.jpg,0,9,76,16,0,101
9500372295.jpg,1,37,67,2,0,107
95019293.jpg,4,56,43,1,0,104
9502087003.jpg,0,6,56,45,0,107
950420073.jpg,0,0,58,49,0,107
9505522131.jpg,0,13,41,54,4,112
9506730000.jpg,4,29,56,16,0,105
9507159381.jpg,2,52,44,5,0,103
9508337257.jpg,7,49,43,4,0,103
9508596066.jpg,0,0,16,94,3,113
9510636160.jpg,0,1,19,80,13,113
9510794857.jpg,21,79,7,1,0,108
9510873691.jpg,0,1,56,45,1,103
9512008685.jpg,1,8,47,44,1,101
9512191283.jpg,0,1,21,81,4,107
9513920516.jpg,0,13,71,16,0,100
9515243339.jpg,0,2,29,73,1,105
9517140367.jpg,0,8,79,16,1,104
9517941769.jpg,1,8,73,25,1,108
9518037590.jpg,0,0,22,79,4,105
9519070785.jpg,0,1,42,62,2,107
952167260.jpg,2,24,66,11,0,103
9521784071.jpg,0,10,87,35,0,132
9522074895.jpg,1,0,14,85,5,105
9522817562.jpg,0,3,34,60,4,101
9523088763.jpg,0,2,45,77,2,126
9523882653.jpg,3,26,62,8,0,99
9524699151.jpg,0,3,11,78,9,101
9525267533.jpg,1,13,78,14,0,106
9526511129.jpg,1,4,42,50,4,101
9526789940.jpg,0,8,81,21,0,110
9526812010.jpg,0,1,54,68,3,126
9527678556.jpg,1,4,54,43,1,103
9527733918.jpg,0,4,47,56,1,108
9527961628.jpg,1,18,99,22,0,140
9527980922.jpg,0,2,38,59,2,101
9528230846.jpg,0,2,32,61,3,98
9528238832.jpg,0,3,70,29,2,104
9528268471.jpg,0,4,26,70,1,101
9530920367.jpg,0,3,43,54,1,101
9530922505.jpg,0,1,37,58,2,98
9534283737.jpg,1,0,20,77,9,107
9535634646.jpg,0,2,81,42,1,126
9535859777.jpg,0,3,64,34,1,102
9536013325.jpg,0,2,35,63,3,103
9536683213.jpg,0,6,52,45,0,103
9537434864.jpg,0,7,76,27,0,110
9538010793.jpg,1,13,114,25,1,154
9538674147.jpg,1,30,65,4,0,100
9539965008.jpg,0,0,34,64,2,100
9540532896.jpg,0,1,18,74,18,111
9541231306.jpg,13,83,8,1,0,105
9541303452.jpg,3,61,61,4,0,129
9541618071.jpg,1,51,50,6,0,108
9543397077.jpg,0,0,29,76,4,109
9544478990.jpg,0,1,23,69,8,101
9544682172.jpg,0,0,19,74,11,104
9545794561.jpg,0,0,47,71,4,122
9546481286.jpg,0,0,18,75,5,98
9547511197.jpg,1,33,104,13,0,151
9549652790.jpg,0,0,27,78,7,112
9549856021.jpg,1,4,68,32,0,105
9550375184.jpg,0,0,20,82,6,108
9550673458.jpg,1,21,69,13,0,104
9553679433.jpg,0,0,47,56,1,104
9554062765.jpg,57,44,6,3,0,110
9557331185.jpg,0,19,75,17,0,111
9560250736.jpg,3,38,53,9,0,103
9561571974.jpg,0,1,53,50,0,104
9561731191.jpg,0,1,33,71,6,111
9562837541.jpg,0,3,21,74,8,106
9565379403.jpg,0,0,20,77,4,101
9566357532.jpg,0,1,29,67,6,103
9567386872.jpg,0,9,77,20,0,106
9569732421.jpg,0,9,63,30,0,102
9569803128.jpg,0,0,50,51,1,102
9571610402.jpg,1,9,49,64,4,127
95721252.jpg,2,40,52,11,0,105
9572676975.jpg,0,3,49,48,5,105
9577464036.jpg,0,18,63,29,0,110
9577991089.jpg,0,35,66,5,0,106
9578088583.jpg,2,54,49,3,0,108
9581038288.jpg,0,2,54,48,1,105
9581108826.jpg,0,0,49,53,2,104
9581336227.jpg,2,14,48,36,2,102
9582086369.jpg,0,2,30,68,6,106
9582851453.jpg,0,14,49,36,2,101
9582874322.jpg,4,48,46,8,0,106
9583278733.jpg,0,3,43,83,2,131
9583424619.jpg,0,4,56,36,2,98
9584563009.jpg,0,9,95,26,0,130
9584749572.jpg,0,10,75,21,0,106
9585740831.jpg,0,1,44,66,1,112
9586652263.jpg,0,1,30,75,1,107
9587142056.jpg,0,1,31,70,2,104
9587630414.jpg,0,0,24,77,6,107
9588413178.jpg,0,2,38,57,0,97
9589321595.jpg,0,2,55,45,0,102
9589470493.jpg,1,8,69,24,0,102
9590556429.jpg,8,65,32,5,0,110
9590947426.jpg,0,2,37,57,3,99
9592992525.jpg,2,25,77,6,0,110
9593149678.jpg,0,3,50,52,0,105
9594906572.jpg,0,1,18,80,5,104
9596892460.jpg,0,1,23,74,2,100
9597188417.jpg,0,22,64,22,0,108
9600932470.jpg,0,5,68,33,0,106
9602489525.jpg,0,11,76,18,1,106
9602714230.jpg,0,7,61,37,0,105
9602922316.jpg,0,2,56,49,0,107
9604185976.jpg,0,1,30,69,3,103
9605303857.jpg,0,6,54,44,0,104
9605307671.jpg,0,3,49,54,1,107
9606718162.jpg,0,0,40,61,5,106
9606775848.jpg,0,2,45,51,5,103
9607964223.jpg,0,1,34,59,1,95
9609818482.jpg,0,4,48,51,1,104
9613563930.jpg,0,0,30,66,6,102
9613807416.jpg,0,0,27,76,3,106
9615457112.jpg,0,1,47,49,5,102
9615940305.jpg,0,2,54,45,1,102
9618300510.jpg,0,1,45,53,0,99
9618361879.jpg,0,0,34,70,3,107
9618367899.jpg,0,0,37,70,2,109
9618688199.jpg,1,9,51,47,3,111
9619949433.jpg,1,30,62,6,0,99
9623701556.jpg,0,1,32,61,9,103
9625138420.jpg,0,0,29,69,6,104
9625551668.jpg,0,38,55,12,0,105
9629455923.jpg,0,28,62,18,0,108
9629668489.jpg,0,0,30,72,2,104
9630240273.jpg,0,12,73,23,0,108
9630325643.jpg,12,61,30,1,0,104
9632208628.jpg,0,41,62,7,0,110
9633489441.jpg,15,56,26,4,0,101
9634215065.jpg,1,2,65,39,0,107
9638117839.jpg,0,7,60,30,1,98
9639418449.jpg,0,1,50,49,4,104
9641836616.jpg,0,1,36,88,1,126
9642249347.jpg,0,17,78,9,1,105
9642841042.jpg,0,5,32,68,0,105
9642860901.jpg,0,0,42,63,1,106
9642986357.jpg,5,64,31,1,0,101
9646156379.jpg,0,2,36,60,2,100
9646776074.jpg,0,1,57,43,1,102
9648319367.jpg,0,2,48,54,0,104
9648549075.jpg,0,0,38,66,2,106
9650165015.jpg,1,27,106,22,0,156
9650999310.jpg,1,44,57,6,0,108
9651547204.jpg,2,30,67,6,0,105
9652506914.jpg,0,1,32,66,3,102
9653610008.jpg,0,1,42,57,3,103
9653701546.jpg,0,13,80,17,0,110
9654367147.jpg,0,3,37,66,1,107
9654393465.jpg,0,12,76,15,0,103
9654462771.jpg,0,0,18,79,14,111
9655773082.jpg,0,0,20,74,5,99
9656195199.jpg,0,16,67,19,1,103
9657096738.jpg,2,9,67,21,0,99
9657273121.jpg,0,7,69,33,0,109
9657446583.jpg,0,3,54,45,1,103
9657450632.jpg,0,5,65,38,0,108
9657756963.jpg,0,5,31,69,2,107
965852463.jpg,0,15,72,18,1,106
9658774813.jpg,0,9,69,32,1,111
9659355544.jpg,0,21,68,12,0,101
9660068454.jpg,0,11,62,21,2,96
9665243526.jpg,0,0,45,54,0,99
96655810.jpg,0,18,61,27,0,106
9665864657.jpg,0,1,61,39,0,101
9668766101.jpg,7,76,18,1,0,102
9669000594.jpg,0,3,67,34,0,104
9669015372.jpg,0,5,78,43,0,126
9669417942.jpg,0,6,51,50,1,108
9670754375.jpg,0,1,19,66,12,98
9671600986.jpg,0,6,61,40,2,109
9673401997.jpg,5,53,82,5,2,147
9674243129.jpg,0,2,69,28,1,100
967548785.jpg,0,25,71,5,0,101
9677255399.jpg,2,83,51,4,0,140
9677256773.jpg,9,64,31,0,0,104
9677297702.jpg,6,67,35,2,0,110
9678381010.jpg,1,27,88,9,0,125
9678787326.jpg,0,7,46,52,0,105
9680493700.jpg,21,82,4,0,1,108
9681377633.jpg,36,58,8,0,0,102
9683345746.jpg,0,11,61,31,1,104
9684211981.jpg,0,0,17,88,5,110
9685106937.jpg,4,42,59,2,0,107
9686337427.jpg,11,67,23,1,0,102
9686480737.jpg,21,83,24,1,0,129
9687081006.jpg,0,3,50,47,1,101
9687603044.jpg,6,55,38,4,0,103
9687869732.jpg,0,4,50,54,2,110
9688720350.jpg,0,13,73,15,0,101
9689861322.jpg,2,44,52,3,0,101
9690359369.jpg,1,5,76,46,0,128
9692018769.jpg,1,43,55,2,0,101
9692544079.jpg,1,50,63,4,0,118
9694060266.jpg,0,3,84,52,1,140
9694884270.jpg,0,24,84,18,0,126
9695487597.jpg,0,0,39,66,1,106
9695883869.jpg,0,0,18,82,8,108
9699196303.jpg,0,0,66,65,3,134
9700041426.jpg,0,2,43,60,1,106
9700460977.jpg,0,3,54,46,3,106
9701303901.jpg,1,55,48,5,0,109
9702019166.jpg,0,5,71,28,1,105
9702746204.jpg,0,4,70,29,0,103
9702908989.jpg,1,2,37,57,7,104
9703418771.jpg,51,54,5,1,0,111
970460687.jpg,0,5,52,55,1,113
9707913077.jpg,0,0,23,67,11,101
9707926050.jpg,11,73,18,2,0,104
9708878805.jpg,0,5,78,24,0,107
9709188366.jpg,0,3,70,64,1,138
9710495757.jpg,0,1,24,70,8,103
9710823281.jpg,2,10,43,40,2,97
9712051180.jpg,0,1,52,53,0,106
9712191760.jpg,0,9,51,42,2,104
9712984770.jpg,0,7,72,26,1,106
9713017105.jpg,0,3,69,67,0,139
9714595106.jpg,0,23,65,11,0,99
9716659455.jpg,0,2,31,67,2,102
9716988368.jpg,0,3,60,69,0,132
9719700871.jpg,0,0,29,71,6,106
9719721958.jpg,0,7,49,52,1,109
9720517445.jpg,0,3,54,41,2,100
9722821291.jpg,8,66,36,2,0,112
9723327327.jpg,0,0,21,84,6,111
9723836931.jpg,0,1,24,75,4,104
9723956053.jpg,0,4,60,37,0,101
9724107986.jpg,0,0,30,79,6,115
9724373732.jpg,1,6,51,45,2,105
9725681826.jpg,0,3,58,42,2,105
9726620129.jpg,0,1,35,64,3,103
9727569377.jpg,0,1,34,66,3,104
9727736297.jpg,0,11,78,21,0,110
9730872137.jpg,0,19,69,15,0,103
9731493509.jpg,13,74,18,0,0,105
9732569997.jpg,0,0,35,70,4,109
9733980007.jpg,0,36,62,5,0,103
9737356732.jpg,0,1,28,74,0,103
9737673243.jpg,0,11,70,18,0,99
9740171796.jpg,0,6,74,48,0,128
9741202505.jpg,55,42,3,0,0,100
9742193422.jpg,0,0,14,93,4,111
9743636678.jpg,30,47,21,4,0,102
9753718946.jpg,0,1,38,56,7,102
9754442293.jpg,0,0,56,80,3,139
9758297555.jpg,1,18,59,24,0,102
9759154326.jpg,0,7,70,35,0,112
9760551223.jpg,0,1,45,56,5,107
9762345346.jpg,0,6,44,54,5,109
9762410596.jpg,0,0,39,67,4,110
9763431522.jpg,0,0,13,83,6,102
9765112254.jpg,1,12,63,30,1,107
9766865862.jpg,1,34,58,10,1,104
9766930762.jpg,5,44,47,7,0,103
9767151984.jpg,12,72,20,0,0,104
9767373513.jpg,6,54,39,2,1,102
9767747482.jpg,0,17,66,21,0,104
9768426856.jpg,0,12,75,21,0,108
976846781.jpg,56,43,4,0,0,103
9768559232.jpg,0,4,42,58,1,105
9768629394.jpg,0,4,55,48,1,108
9768810935.jpg,3,10,69,20,3,105
9769299262.jpg,0,33,76,3,0,112
9770742411.jpg,0,2,35,62,3,102
9772275331.jpg,0,2,32,73,4,111
9774901765.jpg,0,28,62,9,0,99
9777290841.jpg,0,1,28,63,7,99
9780398791.jpg,0,0,62,53,0,115
9784161203.jpg,33,64,9,1,0,107
9784668705.jpg,0,1,46,63,0,110
9788787724.jpg,8,78,18,0,0,104
9795259723.jpg,0,1,53,52,0,106
9795395745.jpg,0,13,54,34,1,102
97984449.jpg,2,32,51,17,0,102
9802094923.jpg,41,56,3,0,0,100
9805144264.jpg,0,15,75,14,0,104
9806684784.jpg,0,1,63,41,0,105
9808126155.jpg,8,71,21,0,0,100
9813135.jpg,1,35,55,12,0,103
9814999.jpg,0,38,53,16,0,107
9819586584.jpg,0,0,42,63,4,109
9821930934.jpg,0,1,43,57,3,104
9822554264.jpg,1,6,73,29,0,109
9822707366.jpg,0,0,31,71,3,105
9822906336.jpg,0,21,61,14,1,97
9823089054.jpg,6,66,33,0,0,105
9823108104.jpg,0,0,40,61,0,101
9823593036.jpg,0,2,52,53,2,109
9826425224.jpg,0,7,66,34,0,107
9829643193.jpg,0,3,46,48,8,105
9831633846.jpg,0,1,54,48,1,104
9834223025.jpg,1,6,67,30,0,104
9835851375.jpg,0,4,38,55,3,100
9842027236.jpg,0,0,25,79,4,108
9842476936.jpg,0,3,32,59,7,101
9843144115.jpg,0,8,65,36,1,110
9844170304.jpg,0,9,66,25,0,100
9847211516.jpg,0,6,65,35,0,106
9849484955.jpg,0,43,61,2,0,106
9859562873.jpg,3,61,37,0,0,101
9866104216.jpg,1,18,78,4,0,101
9866692876.jpg,0,1,48,58,0,107
9873105273.jpg,0,5,61,37,1,104
9876829794.jpg,0,1,36,63,4,104
9877013785.jpg,0,1,48,53,5,107
9877078626.jpg,0,3,32,55,4,94
9878706283.jpg,0,25,65,13,1,104
9884648494.jpg,0,0,37,69,5,111
9884831806.jpg,0,2,59,40,0,101
9895608016.jpg,1,16,81,7,1,106
9895678845.jpg,0,3,81,16,1,101
9898091624.jpg,3,18,80,5,0,106
9905421695.jpg,0,7,72,29,0,108
9905676544.jpg,1,21,65,16,0,103
9906667675.jpg,4,65,37,0,0,106
9910043795.jpg,0,1,31,71,1,104
9910216783.jpg,0,0,23,72,8,103
9913105155.jpg,0,1,36,64,6,107
9915601385.jpg,0,4,50,47,4,105
9916890605.jpg,0,8,72,19,0,99
9919248523.jpg,0,3,44,53,1,101
9923517944.jpg,1,18,63,31,0,113
9923882853.jpg,0,18,65,22,1,106
9923967865.jpg,0,0,18,73,19,110
9925803176.jpg,2,36,65,8,0,111
9927178013.jpg,3,67,36,0,0,106
992920521.jpg,0,3,57,46,0,106
9932883805.jpg,0,0,45,61,1,107
9933953566.jpg,0,1,57,45,0,103
9934338535.jpg,0,2,32,66,2,102
9935149655.jpg,1,22,96,19,0,138
99355212.jpg,0,5,64,32,0,101
9935622.jpg,2,56,43,5,0,106
9936084895.jpg,0,5,63,30,0,98
9937341544.jpg,0,1,21,72,3,97
9941134286.jpg,0,2,55,50,1,108
9941646054.jpg,0,20,66,17,0,103
9942057643.jpg,0,1,42,82,2,127
9942195273.jpg,0,0,31,76,1,108
9945099433.jpg,3,30,81,11,0,125
9947368873.jpg,0,4,55,70,1,130
9954707815.jpg,2,20,60,26,0,108
9960023395.jpg,0,3,61,44,1,109
9961801436.jpg,24,90,31,1,0,146
9962870083.jpg,2,20,74,10,0,106
9967844514.jpg,0,7,89,56,1,153
9973079444.jpg,1,7,66,25,1,100
9975733946.jpg,0,3,50,56,3,112
9977056676.jpg,0,34,64,5,0,103
9977191265.jpg,0,1,44,58,5,108
9978257554.jpg,0,2,52,49,2,105
9984535544.jpg,0,0,46,55,3,104
9991658304.jpg,0,1,12,85,6,104
9991999836.jpg,0,0,15,79,7,101
9995874256.jpg,0,3,53,51,1,108
9996001596.jpg,0,2,57,43,1,103